experiment,condition_type,participantid,sensationseeking,bored,enjoysamemovies_reverseCoded,practice_hits,control_hits,total,practice_minus_control,practice_plus_control,DR_score,DR_score_%,,
1,NA,1,3.5,4,3,14,6,20,8,20,160,0.278,,
1,NA,2,2.5,3,2,12,3,15,9,15,135,0.234,,
1,NA,3,4,3,5,15,10,26,5,25,125,0.217,,
1,NA,4,3.5,5,2,18,14,32,4,32,128,0.222,,
1,NA,5,2,3,1,10,1,12,9,11,99,0.172,,
1,NA,6,2.5,2,3,13,8,21,5,21,105,0.182,,
1,NA,7,3.5,4,3,13,9,22,4,22,88,0.153,,
1,NA,8,1,1,1,12,8,21,4,20,80,0.139,,
1,NA,9,4,5,3,12,8,20,4,20,80,0.139,,
1,NA,10,2.5,3,2,11,7,19,4,18,72,0.125,,
1,NA,11,3.5,5,2,11,7,18,4,18,72,0.125,,
1,NA,12,2,3,1,16,14,30,2,30,60,0.104,,
1,NA,13,4.5,4,5,10,7,17,3,17,51,0.089,,
1,NA,14,1,1,1,13,11,24,2,24,48,0.083,,
1,NA,15,3.5,3,4,12,10,24,2,22,44,0.076,,
1,NA,16,1.5,2,1,12,10,22,2,22,44,0.076,,
1,NA,17,2.5,3,2,8,5,15,3,13,39,0.068,,
1,NA,18,2.5,3,2,8,5,13,3,13,39,0.068,,
1,NA,19,2.5,2,3,8,5,13,3,13,39,0.068,,
1,NA,20,2.5,4,1,10,8,19,2,18,36,0.063,,
1,NA,21,2,3,1,10,8,18,2,18,36,0.063,,
1,NA,22,2,2,2,10,8,18,2,18,36,0.063,,
1,NA,23,1.5,1,2,9,7,16,2,16,32,0.056,,
1,NA,24,2.5,2,3,9,7,16,2,16,32,0.056,,
1,NA,25,3.5,3,4,15,14,29,1,29,29,0.050,,
1,NA,26,3.5,3,4,8,6,14,2,14,28,0.049,,
1,NA,27,2.5,2,3,8,6,14,2,14,28,0.049,,
1,NA,28,2.5,3,2,8,6,16,2,14,28,0.049,,
1,NA,29,3,4,2,6,3,10,3,9,27,0.047,,
1,NA,30,1.5,1,2,12,11,23,1,23,23,0.040,,
1,NA,31,1.5,1,2,11,10,21,1,21,21,0.036,,
1,NA,32,3,3,3,11,10,21,1,21,21,0.036,,
1,NA,33,3,2,4,6,4,10,2,10,20,0.035,,
1,NA,34,2,2,2,10,9,19,1,19,19,0.033,,
1,NA,35,3,4,2,5,3,9,2,8,16,0.028,,
1,NA,36,4,5,3,8,7,17,1,15,15,0.026,,
1,NA,37,3.5,4,3,7,6,14,1,13,13,0.023,,
1,NA,38,2.5,2,3,7,6,13,1,13,13,0.023,,
1,NA,39,3.5,5,2,7,6,13,1,13,13,0.023,,
1,NA,40,2.5,2,3,5,4,9,1,9,9,0.016,,
1,NA,41,3.5,4,3,4,3,7,1,7,7,0.012,,
1,NA,42,1,1,1,3,2,5,1,5,5,0.009,,
1,NA,43,3.5,3,4,1,0,1,1,1,1,0.002,,
1,NA,44,3.5,4,3,6,6,12,0,12,0,0.000,,
1,NA,45,3.5,3,4,11,11,34,0,22,0,0.000,,
1,NA,46,2,3,1,8,8,16,0,16,0,0.000,,
1,NA,47,2.5,2,3,5,5,11,0,10,0,0.000,,
1,NA,48,2.5,1,4,9,9,18,0,18,0,0.000,,
1,NA,49,1.5,2,1,4,4,8,0,8,0,0.000,,
1,NA,50,3.5,3,4,8,8,16,0,16,0,0.000,,
1,NA,51,2.5,2,3,11,11,22,0,22,0,0.000,,
1,NA,52,3,4,2,1,1,4,0,2,0,0.000,,
1,NA,53,3.5,4,3,9,9,18,0,18,0,0.000,,
1,NA,54,2,3,1,12,12,24,0,24,0,0.000,,
1,NA,55,3,3,3,1,1,2,0,2,0,0.000,,
1,NA,56,3,4,2,16,16,33,0,32,0,0.000,,
1,NA,57,2,2,2,11,11,22,0,22,0,0.000,,
1,NA,58,3,5,1,6,6,12,0,12,0,0.000,,
1,NA,59,3,5,1,0,1,1,-1,1,-1,-0.002,,
1,NA,60,2.5,2,3,1,2,3,-1,3,-3,-0.005,,
1,NA,61,3,2,4,3,4,7,-1,7,-7,-0.012,,
1,NA,62,3,4,2,3,4,7,-1,7,-7,-0.012,,
1,NA,63,4,5,3,3,4,7,-1,7,-7,-0.012,,
1,NA,64,3.5,5,2,3,4,8,-1,7,-7,-0.012,,
1,NA,65,1.5,1,2,1,3,4,-2,4,-8,-0.014,,
1,NA,66,2.5,3,2,1,3,5,-2,4,-8,-0.014,,
1,NA,67,3.5,2,5,4,5,9,-1,9,-9,-0.016,,
1,NA,68,3,4,2,4,5,9,-1,9,-9,-0.016,,
1,NA,69,2,3,1,4,5,9,-1,9,-9,-0.016,,
1,NA,70,3.5,3,4,5,6,12,-1,11,-11,-0.019,,
1,NA,71,5,5,5,5,6,13,-1,11,-11,-0.019,,
1,NA,72,3.5,3,4,6,7,14,-1,13,-13,-0.023,,
1,NA,73,3.5,5,2,7,8,16,-1,15,-15,-0.026,,
1,NA,74,4,5,3,3,5,9,-2,8,-16,-0.028,,
1,NA,75,1.5,2,1,9,10,20,-1,19,-19,-0.033,,
1,NA,76,2.5,4,1,4,6,10,-2,10,-20,-0.035,,
1,NA,77,3.5,5,2,4,6,10,-2,10,-20,-0.035,,
1,NA,78,4,5,3,10,11,21,-1,21,-21,-0.036,,
1,NA,79,4.5,4,5,10,11,21,-1,21,-21,-0.036,,
1,NA,80,3.5,3,4,11,12,25,-1,23,-23,-0.040,,
1,NA,81,2.5,2,3,13,14,28,-1,27,-27,-0.047,,
1,NA,82,2,2,2,6,8,14,-2,14,-28,-0.049,,
1,NA,83,3,4,2,2,6,9,-4,8,-32,-0.056,,
1,NA,84,2.5,2,3,8,10,18,-2,18,-36,-0.063,,
1,NA,85,3,3,3,8,10,18,-2,18,-36,-0.063,,
1,NA,86,2,2,2,8,10,18,-2,18,-36,-0.063,,
1,NA,87,1.5,2,1,9,11,21,-2,20,-40,-0.069,,
1,NA,88,2,2,2,10,12,22,-2,22,-44,-0.076,,
1,NA,89,3,5,1,6,9,15,-3,15,-45,-0.078,,
1,NA,90,3,4,2,10,12,26,-2,22,-44,-0.076,,
1,NA,91,1.5,2,1,3,8,12,-5,11,-55,-0.095,,
1,NA,92,4.5,4,5,13,15,29,-2,28,-56,-0.097,,
1,NA,93,3.5,3,4,8,11,19,-3,19,-57,-0.099,,
1,NA,94,2.5,3,2,8,11,19,-3,19,-57,-0.099,,
1,NA,95,2.5,3,2,8,11,20,-3,19,-57,-0.099,,
1,NA,96,3,3,3,7,11,18,-4,18,-72,-0.125,,
1,NA,97,3.5,3,4,5,10,15,-5,15,-75,-0.130,,
1,NA,98,2,2,2,8,12,20,-4,20,-80,-0.139,,
1,NA,99,2.5,4,1,8,12,20,-4,20,-80,-0.139,,
1,NA,100,2,3,1,6,11,17,-5,17,-85,-0.148,,
1,NA,101,1,1,1,6,11,22,-5,17,-85,-0.148,,
1,NA,102,3,4,2,6,11,18,-5,17,-85,-0.148,,
1,NA,103,2.5,4,1,10,14,25,-4,24,-96,-0.167,,
1,NA,104,2.5,3,2,11,15,26,-4,26,-104,-0.181,,
1,NA,105,2,2,2,11,15,27,-4,26,-104,-0.181,,
1,NA,106,4,5,3,12,16,28,-4,28,-112,-0.194,,
1,NA,107,2,3,1,13,17,30,-4,30,-120,-0.208,,
1,NA,108,3.5,3,4,5,12,18,-7,17,-119,-0.207,,
1,NA,109,4,4,4,5,13,18,-8,18,-144,-0.250,,
1,NA,110,4.5,4,5,9,15,24,-6,24,-144,-0.250,,
1,NA,111,2.5,3,2,9,15,24,-6,24,-144,-0.250,,
1,NA,112,3.5,3,4,13,20,33,-7,33,-231,-0.401,,
2,NA,1,1,1,1,16,10,26,6,26,156,0.271,,
2,NA,2,4,4,4,17,12,31,5,29,145,0.252,,
2,NA,3,2.5,2,3,12,4,17,8,16,128,0.222,,
2,NA,4,3.5,4,3,14,8,23,6,22,132,0.229,,
2,NA,5,2,3,1,14,9,23,5,23,115,0.200,,
2,NA,6,1.5,2,1,14,9,23,5,23,115,0.200,,
2,NA,7,1.5,2,1,15,11,28,4,26,104,0.181,,
2,NA,8,2.5,4,1,15,11,26,4,26,104,0.181,,
2,NA,9,3,5,1,15,11,27,4,26,104,0.181,,
2,NA,10,2.5,4,1,11,5,17,6,16,96,0.167,,
2,NA,11,3,2,4,12,7,20,5,19,95,0.165,,
2,NA,12,2.5,2,3,12,7,19,5,19,95,0.165,,
2,NA,13,3,4,2,17,14,31,3,31,93,0.161,,
2,NA,14,3.5,4,3,17,14,31,3,31,93,0.161,,
2,NA,15,3.5,3,4,13,9,22,4,22,88,0.153,,
2,NA,16,3,4,2,11,7,20,4,18,72,0.125,,
2,NA,17,2.5,2,3,10,5,15,5,15,75,0.130,,
2,NA,18,4,3,5,11,7,18,4,18,72,0.125,,
2,NA,19,2,2,2,10,6,17,4,16,64,0.111,,
2,NA,20,1.5,1,2,9,4,14,5,13,65,0.113,,
2,NA,21,3.5,4,3,9,4,13,5,13,65,0.113,,
2,NA,22,1.5,1,2,10,6,16,4,16,64,0.111,,
2,NA,23,2,1,3,9,5,15,4,14,56,0.097,,
2,NA,24,3,5,1,13,11,24,2,24,48,0.083,,
2,NA,25,2,2,2,8,4,12,4,12,48,0.083,,
2,NA,26,5,5,5,8,4,12,4,12,48,0.083,,
2,NA,27,3,3,3,13,11,24,2,24,48,0.083,,
2,NA,28,4,4,4,9,6,15,3,15,45,0.078,,
2,NA,29,3.5,5,2,9,6,15,3,15,45,0.078,,
2,NA,30,3.5,4,3,9,6,15,3,15,45,0.078,,
2,NA,31,3,3,3,7,3,11,4,10,40,0.069,,
2,NA,32,2.5,3,2,8,5,14,3,13,39,0.068,,
2,NA,33,2,2,2,11,9,20,2,20,40,0.069,,
2,NA,34,2.5,4,1,8,5,13,3,13,39,0.068,,
2,NA,35,3,3,3,8,5,14,3,13,39,0.068,,
2,NA,36,2,2,2,10,8,18,2,18,36,0.063,,
2,NA,37,2,3,1,7,4,14,3,11,33,0.057,,
2,NA,38,2,2,2,14,13,28,1,27,27,0.047,,
2,NA,39,2,2,2,7,5,13,2,12,24,0.042,,
2,NA,40,3,3,3,12,11,26,1,23,23,0.040,,
2,NA,41,3,3,3,13,12,26,1,25,25,0.043,,
2,NA,42,3.5,4,3,13,12,25,1,25,25,0.043,,
2,NA,43,3.5,5,2,13,12,25,1,25,25,0.043,,
2,NA,44,1.5,1,2,7,5,13,2,12,24,0.042,,
2,NA,45,2.5,3,2,7,5,13,2,12,24,0.042,,
2,NA,46,2.5,4,1,5,1,6,4,6,24,0.042,,
2,NA,47,2.5,4,1,11,10,21,1,21,21,0.036,,
2,NA,48,3.5,3,4,5,2,7,3,7,21,0.036,,
2,NA,49,1.5,1,2,10,9,22,1,19,19,0.033,,
2,NA,50,2,2,2,10,9,20,1,19,19,0.033,,
2,NA,51,3.5,4,3,5,3,9,2,8,16,0.028,,
2,NA,52,4.5,4,5,7,6,21,1,13,13,0.023,,
2,NA,53,3,3,3,8,7,15,1,15,15,0.026,,
2,NA,54,3.5,3,4,4,1,5,3,5,15,0.026,,
2,NA,55,2.5,2,3,7,6,15,1,13,13,0.023,,
2,NA,56,2,3,1,4,2,7,2,6,12,0.021,,
2,NA,57,2.5,4,1,6,5,12,1,11,11,0.019,,
2,NA,58,1,1,1,6,5,11,1,11,11,0.019,,
2,NA,59,2,3,1,3,0,3,3,3,9,0.016,,
2,NA,60,3.5,4,3,3,1,4,2,4,8,0.014,,
2,NA,61,2,2,2,3,1,4,2,4,8,0.014,,
2,NA,62,1.5,1,2,2,0,2,2,2,4,0.007,,
2,NA,63,2,3,1,2,0,2,2,2,4,0.007,,
2,NA,64,3.5,4,3,2,1,4,1,3,3,0.005,,
2,NA,65,3,4,2,1,0,1,1,1,1,0.002,,
2,NA,66,1.5,1,2,11,11,22,0,22,0,0.000,,
2,NA,67,2.5,2,3,8,8,16,0,16,0,0.000,,
2,NA,68,3.5,4,3,17,17,34,0,34,0,0.000,,
2,NA,69,3.5,4,3,0,0,9,0,0,0,0.000,,
2,NA,70,3.5,3,4,11,11,23,0,22,0,0.000,,
2,NA,71,4,5,3,17,17,34,0,34,0,0.000,,
2,NA,72,3,3,3,9,9,18,0,18,0,0.000,,
2,NA,73,2,3,1,14,14,29,0,28,0,0.000,,
2,NA,74,3,5,1,6,6,14,0,12,0,0.000,,
2,NA,75,3.5,5,2,5,5,10,0,10,0,0.000,,
2,NA,76,2.5,4,1,0,0,0,0,0,0,0.000,,
2,NA,77,2.5,4,1,21,21,42,0,42,0,0.000,,
2,NA,78,2.5,3,2,4,4,8,0,8,0,0.000,,
2,NA,79,2.5,3,2,9,9,21,0,18,0,0.000,,
2,NA,80,2.5,1,4,5,5,10,0,10,0,0.000,,
2,NA,81,3.5,5,2,5,5,11,0,10,0,0.000,,
2,NA,82,4,5,3,9,9,20,0,18,0,0.000,,
2,NA,83,2,2,2,0,1,3,-1,1,-1,-0.002,,
2,NA,84,3,5,1,0,2,2,-2,2,-4,-0.007,,
2,NA,85,3.5,3,4,2,3,5,-1,5,-5,-0.009,,
2,NA,86,1.5,2,1,3,4,7,-1,7,-7,-0.012,,
2,NA,87,1.5,2,1,3,4,8,-1,7,-7,-0.012,,
2,NA,88,3.5,4,3,4,5,9,-1,9,-9,-0.016,,
2,NA,89,1.5,2,1,4,5,9,-1,9,-9,-0.016,,
2,NA,90,3.5,4,3,5,6,12,-1,11,-11,-0.019,,
2,NA,91,3,5,1,5,6,11,-1,11,-11,-0.019,,
2,NA,92,4.5,4,5,2,4,6,-2,6,-12,-0.021,,
2,NA,93,4.5,5,4,1,4,5,-3,5,-15,-0.026,,
2,NA,94,1.5,2,1,7,8,16,-1,15,-15,-0.026,,
2,NA,95,1.5,2,1,7,8,15,-1,15,-15,-0.026,,
2,NA,96,4,4,4,3,5,8,-2,8,-16,-0.028,,
2,NA,97,2.5,3,2,3,5,8,-2,8,-16,-0.028,,
2,NA,98,2.5,3,2,3,5,10,-2,8,-16,-0.028,,
2,NA,99,2,3,1,8,9,18,-1,17,-17,-0.030,,
2,NA,100,3.5,4,3,8,9,19,-1,17,-17,-0.030,,
2,NA,101,3,4,2,9,10,21,-1,19,-19,-0.033,,
2,NA,102,2,2,2,9,10,19,-1,19,-19,-0.033,,
2,NA,103,2.5,3,2,9,10,19,-1,19,-19,-0.033,,
2,NA,104,5,5,5,4,6,10,-2,10,-20,-0.035,,
2,NA,105,3,4,2,9,10,20,-1,19,-19,-0.033,,
2,NA,106,2,3,1,4,6,10,-2,10,-20,-0.035,,
2,NA,107,2,1,3,10,11,23,-1,21,-21,-0.036,,
2,NA,108,2.5,3,2,11,12,23,-1,23,-23,-0.040,,
2,NA,109,2.5,4,1,11,12,24,-1,23,-23,-0.040,,
2,NA,110,4,4,4,10,11,23,-1,21,-21,-0.036,,
2,NA,111,2,2,2,11,12,23,-1,23,-23,-0.040,,
2,NA,112,2.5,3,2,11,12,23,-1,23,-23,-0.040,,
2,NA,113,5,5,5,5,7,12,-2,12,-24,-0.042,,
2,NA,114,4,3,5,5,7,14,-2,12,-24,-0.042,,
2,NA,115,4,4,4,5,7,12,-2,12,-24,-0.042,,
2,NA,116,1,1,1,5,7,12,-2,12,-24,-0.042,,
2,NA,117,2.5,3,2,6,8,14,-2,14,-28,-0.049,,
2,NA,118,4,3,5,6,8,15,-2,14,-28,-0.049,,
2,NA,119,2,3,1,6,8,14,-2,14,-28,-0.049,,
2,NA,120,3.5,5,2,14,15,29,-1,29,-29,-0.050,,
2,NA,121,3,5,1,15,16,31,-1,31,-31,-0.054,,
2,NA,122,1.5,2,1,2,6,9,-4,8,-32,-0.056,,
2,NA,123,3,5,1,7,9,16,-2,16,-32,-0.056,,
2,NA,124,3,5,1,6,8,16,-2,14,-28,-0.049,,
2,NA,125,3.5,4,3,2,6,8,-4,8,-32,-0.056,,
2,NA,126,4.5,5,4,7,9,17,-2,16,-32,-0.056,,
2,NA,127,3,3,3,8,10,19,-2,18,-36,-0.063,,
2,NA,128,2,2,2,9,11,20,-2,20,-40,-0.069,,
2,NA,129,3,5,1,3,7,11,-4,10,-40,-0.069,,
2,NA,130,2.5,3,2,9,11,20,-2,20,-40,-0.069,,
2,NA,131,2.5,4,1,3,7,10,-4,10,-40,-0.069,,
2,NA,132,3,3,3,6,9,15,-3,15,-45,-0.078,,
2,NA,133,4.5,4,5,4,8,12,-4,12,-48,-0.083,,
2,NA,134,1,1,1,11,13,24,-2,24,-48,-0.083,,
2,NA,135,1,1,1,6,9,18,-3,15,-45,-0.078,,
2,NA,136,3,2,4,12,14,27,-2,26,-52,-0.090,,
2,NA,137,2,3,1,3,8,14,-5,11,-55,-0.095,,
2,NA,138,3,2,4,13,15,29,-2,28,-56,-0.097,,
2,NA,139,3.5,5,2,8,11,20,-3,19,-57,-0.099,,
2,NA,140,2,2,2,8,11,20,-3,19,-57,-0.099,,
2,NA,141,3,4,2,9,12,21,-3,21,-63,-0.109,,
2,NA,142,2.5,3,2,6,10,17,-4,16,-64,-0.111,,
2,NA,143,3,4,2,10,13,23,-3,23,-69,-0.120,,
2,NA,144,3,4,2,4,9,14,-5,13,-65,-0.113,,
2,NA,145,4,5,3,10,13,25,-3,23,-69,-0.120,,
2,NA,146,2.5,1,4,11,14,25,-3,25,-75,-0.130,,
2,NA,147,2.5,4,1,8,12,20,-4,20,-80,-0.139,,
2,NA,148,2,2,2,8,12,24,-4,20,-80,-0.139,,
2,NA,149,1.5,1,2,8,12,22,-4,20,-80,-0.139,,
2,NA,150,3,3,3,9,13,22,-4,22,-88,-0.153,,
2,NA,151,3,5,1,14,17,31,-3,31,-93,-0.161,,
2,NA,152,1.5,2,1,14,17,32,-3,31,-93,-0.161,,
2,NA,153,2,1,3,16,19,36,-3,35,-105,-0.182,,
2,NA,154,3,3,3,4,11,16,-7,15,-105,-0.182,,
2,NA,155,4,5,3,11,16,31,-5,27,-135,-0.234,,
2,NA,156,4.5,5,4,8,14,27,-6,22,-132,-0.229,,
2,NA,157,2.5,2,3,14,19,33,-5,33,-165,-0.286,,
2,NA,158,2.5,4,1,8,15,25,-7,23,-161,-0.280,,
3,NA,1,4,4.00,4.0,16,10,26,6,26,156,0.271,,
3,NA,2,3.5,3.00,4.0,13,4,17,9,17,153,0.266,,
3,NA,3,2.5,1.00,4.0,17,12,30,5,29,145,0.252,,
3,NA,4,5,5.00,5.0,16,11,27,5,27,135,0.234,,
3,NA,5,5,5.00,5.0,14,8,22,6,22,132,0.229,,
3,NA,6,3,2.00,4.0,13,7,20,6,20,120,0.208,,
3,NA,7,3,2.00,4.0,13,7,20,6,20,120,0.208,,
3,NA,8,4,4.00,4.0,13,7,26,6,20,120,0.208,,
3,NA,9,3.5,4.00,3.0,14,10,25,4,24,96,0.167,,
3,NA,10,2.5,3.00,2.0,12,7,21,5,19,95,0.165,,
3,NA,11,3,3.00,3.0,11,6,18,5,17,85,0.148,,
3,NA,12,3.5,4.00,3.0,11,6,18,5,17,85,0.148,,
3,NA,13,3.5,4.00,3.0,10,4,14,6,14,84,0.146,,
3,NA,14,3.5,2.00,5.0,15,12,27,3,27,81,0.141,,
3,NA,15,4.5,5.00,4.0,9,4,13,5,13,65,0.113,,
3,NA,16,3.5,4.00,3.0,10,6,16,4,16,64,0.111,,
3,NA,17,3.5,4.00,3.0,12,9,21,3,21,63,0.109,,
3,NA,18,1.5,1.00,2.0,12,9,23,3,21,63,0.109,,
3,NA,19,4,4.00,4.0,12,9,21,3,21,63,0.109,,
3,NA,20,4,3.00,5.0,12,9,21,3,21,63,0.109,,
3,NA,21,4.5,4.00,5.0,11,8,19,3,19,57,0.099,,
3,NA,22,3,4.00,2.0,11,8,19,3,19,57,0.099,,
3,NA,23,4.5,4.00,5.0,9,5,14,4,14,56,0.097,,
3,NA,24,3,2.00,4.0,8,3,12,5,11,55,0.095,,
3,NA,25,3.5,4.00,3.0,8,3,12,5,11,55,0.095,,
3,NA,26,4,4.00,4.0,10,7,18,3,17,51,0.089,,
3,NA,27,3,2.00,4.0,13,11,24,2,24,48,0.083,,
3,NA,28,2.5,3.00,2.0,13,11,24,2,24,48,0.083,,
3,NA,29,3,3.00,3.0,13,11,24,2,24,48,0.083,,
3,NA,30,4,4.00,4.0,9,6,15,3,15,45,0.078,,
3,NA,31,4.5,5.00,4.0,12,10,22,2,22,44,0.076,,
3,NA,32,4,4.00,4.0,12,10,22,2,22,44,0.076,,
3,NA,33,2.5,3.00,2.0,12,10,22,2,22,44,0.076,,
3,NA,34,5,5.00,5.0,7,3,11,4,10,40,0.069,,
3,NA,35,4,4.00,4.0,11,9,20,2,20,40,0.069,,
3,NA,36,3.5,4.00,3.0,10,8,18,2,18,36,0.063,,
3,NA,37,3.5,3.00,4.0,10,8,18,2,18,36,0.063,,
3,NA,38,3,4.00,2.0,10,8,18,2,18,36,0.063,,
3,NA,39,2.5,2.00,3.0,7,4,11,3,11,33,0.057,,
3,NA,40,4,4.00,4.0,7,4,13,3,11,33,0.057,,
3,NA,41,3.5,4.00,3.0,9,7,16,2,16,32,0.056,,
3,NA,42,2.5,2.00,3.0,6,2,9,4,8,32,0.056,,
3,NA,43,3,3.00,3.0,9,7,17,2,16,32,0.056,,
3,NA,44,4,5.00,3.0,8,6,14,2,14,28,0.049,,
3,NA,45,3,2.00,4.0,7,5,12,2,12,24,0.042,,
3,NA,46,3,4.00,2.0,10,9,19,1,19,19,0.033,,
3,NA,47,4.5,4.00,5.0,10,9,19,1,19,19,0.033,,
3,NA,48,3.5,3.00,4.0,10,9,19,1,19,19,0.033,,
3,NA,49,5,5.00,5.0,9,8,18,1,17,17,0.030,,
3,NA,50,3,1.00,5.0,8,7,15,1,15,15,0.026,,
3,NA,51,3,4.00,2.0,5,4,11,1,9,9,0.016,,
3,NA,52,3,3.00,3.0,3,1,5,2,4,8,0.014,,
3,NA,53,4.5,4.00,5.0,4,3,8,1,7,7,0.012,,
3,NA,54,3.5,4.00,3.0,3,2,6,1,5,5,0.009,,
3,NA,55,3.5,3.00,4.0,2,1,3,1,3,3,0.005,,
3,NA,56,3.5,3.00,4.0,13,13,27,0,26,0,0.000,,
3,NA,57,4,3.00,5.0,16,16,33,0,32,0,0.000,,
3,NA,58,4,3.00,5.0,10,10,21,0,20,0,0.000,,
3,NA,59,3.5,3.00,4.0,5,5,10,0,10,0,0.000,,
3,NA,60,2.5,3.00,2.0,5,5,10,0,10,0,0.000,,
3,NA,61,4,3.00,5.0,9,9,20,0,18,0,0.000,,
3,NA,62,3.5,3.00,4.0,0,0,0,0,0,0,0.000,,
3,NA,63,4,4.00,4.0,5,5,10,0,10,0,0.000,,
3,NA,64,2.5,3.00,2.0,6,6,12,0,12,0,0.000,,
3,NA,65,4,4.00,4.0,8,8,16,0,16,0,0.000,,
3,NA,66,4,4.00,4.0,7,7,15,0,14,0,0.000,,
3,NA,67,4,4.00,4.0,11,11,22,0,22,0,0.000,,
3,NA,68,3,1.00,5.0,12,12,25,0,24,0,0.000,,
3,NA,69,2.5,3.00,2.0,7,7,14,0,14,0,0.000,,
3,NA,70,4,4.00,4.0,4,4,8,0,8,0,0.000,,
3,NA,71,4,5.00,3.0,4,4,8,0,8,0,0.000,,
3,NA,72,3,4.00,2.0,6,6,13,0,12,0,0.000,,
3,NA,73,4,4.00,4.0,3,3,6,0,6,0,0.000,,
3,NA,74,3,3.00,3.0,2,2,4,0,4,0,0.000,,
3,NA,75,3.5,3.00,4.0,13,13,28,0,26,0,0.000,,
3,NA,76,5,5.00,5.0,4,5,9,-1,9,-9,-0.016,,
3,NA,77,5,5.00,5.0,5,6,12,-1,11,-11,-0.019,,
3,NA,78,1.5,2.00,1.0,6,7,13,-1,13,-13,-0.023,,
3,NA,79,4.5,4.00,5.0,6,7,13,-1,13,-13,-0.023,,
3,NA,80,4,4.00,4.0,6,7,13,-1,13,-13,-0.023,,
3,NA,81,3.5,4.00,3.0,7,8,15,-1,15,-15,-0.026,,
3,NA,82,4.5,4.00,5.0,7,8,15,-1,15,-15,-0.026,,
3,NA,83,2.5,4.00,1.0,7,8,15,-1,15,-15,-0.026,,
3,NA,84,4,3.00,5.0,3,5,10,-2,8,-16,-0.028,,
3,NA,85,3.5,4.00,3.0,8,9,17,-1,17,-17,-0.030,,
3,NA,86,3.5,4.00,3.0,8,9,18,-1,17,-17,-0.030,,
3,NA,87,4,4.00,4.0,11,12,23,-1,23,-23,-0.040,,
3,NA,88,2.5,2.00,3.0,11,12,24,-1,23,-23,-0.040,,
3,NA,89,5,5.00,5.0,13,14,29,-1,27,-27,-0.047,,
3,NA,90,3.5,3.00,4.0,6,8,14,-2,14,-28,-0.049,,
3,NA,91,4.5,5.00,4.0,6,8,16,-2,14,-28,-0.049,,
3,NA,92,4,4.00,4.0,6,8,14,-2,14,-28,-0.049,,
3,NA,93,4,3.00,5.0,7,9,17,-2,16,-32,-0.056,,
3,NA,94,3,2.00,4.0,7,9,16,-2,16,-32,-0.056,,
3,NA,95,4,4.00,4.0,4,7,11,-3,11,-33,-0.057,,
3,NA,96,4,3.00,5.0,4,7,12,-3,11,-33,-0.057,,
3,NA,97,3.5,3.00,4.0,4,7,12,-3,11,-33,-0.057,,
3,NA,98,3,3.00,3.0,1,6,7,-5,7,-35,-0.061,,
3,NA,99,4,3.00,5.0,8,10,18,-2,18,-36,-0.063,,
3,NA,100,2.5,3.00,2.0,8,10,18,-2,18,-36,-0.063,,
3,NA,101,3.5,3.00,4.0,5,8,13,-3,13,-39,-0.068,,
3,NA,102,4,4.00,4.0,9,11,20,-2,20,-40,-0.069,,
3,NA,103,3,2.00,4.0,10,12,24,-2,22,-44,-0.076,,
3,NA,104,4,5.00,3.0,1,7,8,-6,8,-48,-0.083,,
3,NA,105,1,1.00,1.0,4,8,16,-4,12,-48,-0.083,,
3,NA,106,3,4.00,2.0,7,10,17,-3,17,-51,-0.089,,
3,NA,107,4,4.00,4.0,13,15,31,-2,28,-56,-0.097,,
3,NA,108,4.5,4.00,5.0,5,9,14,-4,14,-56,-0.097,,
3,NA,109,4,4.00,4.0,13,15,28,-2,28,-56,-0.097,,
3,NA,110,4,4.00,4.0,8,11,19,-3,19,-57,-0.099,,
3,NA,111,2.5,3.00,2.0,8,11,19,-3,19,-57,-0.099,,
3,NA,112,5,5.00,5.0,9,12,21,-3,21,-63,-0.109,,
3,NA,113,4,4.00,4.0,6,10,16,-4,16,-64,-0.111,,
3,NA,114,3,3.00,3.0,6,10,16,-4,16,-64,-0.111,,
3,NA,115,3,4.00,2.0,6,10,16,-4,16,-64,-0.111,,
3,NA,116,4.5,5.00,4.0,11,14,25,-3,25,-75,-0.130,,
3,NA,117,4.5,4.00,5.0,11,14,25,-3,25,-75,-0.130,,
3,NA,118,3,2.00,4.0,5,10,15,-5,15,-75,-0.130,,
3,NA,119,3,2.00,4.0,5,10,15,-5,15,-75,-0.130,,
3,NA,120,3.5,5.00,2.0,10,14,24,-4,24,-96,-0.167,,
3,NA,121,4.5,5.00,4.0,10,14,24,-4,24,-96,-0.167,,
3,NA,122,3.5,3.00,4.0,7,13,20,-6,20,-120,-0.208,,
3,NA,123,3.5,3.00,4.0,7,14,22,-7,21,-147,-0.255,,
3,NA,124,3.5,3.00,4.0,9,16,26,-7,25,-175,-0.304,,
4,NA,1,4.5,4,5,16,8,26,8,24,192,0.333,,
4,NA,2,2.5,1,4,15,7,22,8,22,176,0.306,,
4,NA,3,3,3,3,16,9,25,7,25,175,0.304,,
4,NA,4,3.5,2,5,13,7,20,6,20,120,0.208,,
4,NA,5,2.5,2,3,17,13,32,4,30,120,0.208,,
4,NA,6,3,2,4,12,6,21,6,18,108,0.188,,
4,NA,7,3,2,4,11,5,16,6,16,96,0.167,,
4,NA,8,2.5,3,2,12,8,20,4,20,80,0.139,,
4,NA,9,2.5,4,1,14,11,25,3,25,75,0.130,,
4,NA,10,3.5,3,4,13,10,24,3,23,69,0.120,,
4,NA,11,4,4,4,9,4,13,5,13,65,0.113,,
4,NA,12,3,3,3,10,6,18,4,16,64,0.111,,
4,NA,13,4.5,4,5,12,9,21,3,21,63,0.109,,
4,NA,14,4,5,3,12,9,21,3,21,63,0.109,,
4,NA,15,4,3,5,8,2,11,6,10,60,0.104,,
4,NA,16,3,4,2,16,14,30,2,30,60,0.104,,
4,NA,17,2,1,3,11,8,19,3,19,57,0.099,,
4,NA,18,5,5,5,9,5,17,4,14,56,0.097,,
4,NA,19,4,3,5,9,5,14,4,14,56,0.097,,
4,NA,20,4,4,4,8,3,12,5,11,55,0.095,,
4,NA,21,2.5,3,2,10,7,17,3,17,51,0.089,,
4,NA,22,2.5,4,1,10,7,17,3,17,51,0.089,,
4,NA,23,3,2,4,7,1,8,6,8,48,0.083,,
4,NA,24,3,4,2,13,11,24,2,24,48,0.083,,
4,NA,25,3.5,3,4,11,9,20,2,20,40,0.069,,
4,NA,26,3,3,3,8,5,14,3,13,39,0.068,,
4,NA,27,4,4,4,6,1,8,5,7,35,0.061,,
4,NA,28,3.5,4,3,7,4,13,3,11,33,0.057,,
4,NA,29,2.5,4,1,17,16,33,1,33,33,0.057,,
4,NA,30,3.5,3,4,6,3,10,3,9,27,0.047,,
4,NA,31,3.5,4,3,6,3,9,3,9,27,0.047,,
4,NA,32,2.5,4,1,7,5,13,2,12,24,0.042,,
4,NA,33,3.5,3,4,12,11,25,1,23,23,0.040,,
4,NA,34,3,2,4,11,10,21,1,21,21,0.036,,
4,NA,35,3,4,2,11,10,21,1,21,21,0.036,,
4,NA,36,2.5,3,2,11,10,21,1,21,21,0.036,,
4,NA,37,4,4,4,6,4,10,2,10,20,0.035,,
4,NA,38,4,4,4,6,4,10,2,10,20,0.035,,
4,NA,39,4.5,4,5,6,4,10,2,10,20,0.035,,
4,NA,40,3.5,4,3,10,9,19,1,19,19,0.033,,
4,NA,41,1.5,1,2,10,9,19,1,19,19,0.033,,
4,NA,42,3.5,3,4,9,8,18,1,17,17,0.030,,
4,NA,43,4,3,5,4,0,4,4,4,16,0.028,,
4,NA,44,5,5,5,5,3,10,2,8,16,0.028,,
4,NA,45,4,4,4,8,7,16,1,15,15,0.026,,
4,NA,46,3.5,3,4,7,6,13,1,13,13,0.023,,
4,NA,47,4,4,4,6,5,11,1,11,11,0.019,,
4,NA,48,3,2,4,6,5,11,1,11,11,0.019,,
4,NA,49,4,4,4,6,5,12,1,11,11,0.019,,
4,NA,50,3.5,5,2,6,5,11,1,11,11,0.019,,
4,NA,51,3,2,4,5,4,9,1,9,9,0.016,,
4,NA,52,3.5,3,4,5,4,10,1,9,9,0.016,,
4,NA,53,4,4,4,3,2,5,1,5,5,0.009,,
4,NA,54,3.5,4,3,0,0,0,0,0,0,0.000,,
4,NA,55,4.5,5,4,4,4,8,0,8,0,0.000,,
4,NA,56,5,5,5,6,6,12,0,12,0,0.000,,
4,NA,57,3.5,3,4,6,6,12,0,12,0,0.000,,
4,NA,58,3.5,3,4,7,7,14,0,14,0,0.000,,
4,NA,59,5,5,5,7,7,14,0,14,0,0.000,,
4,NA,60,2.5,3,2,8,8,18,0,16,0,0.000,,
4,NA,61,2,2,2,8,8,16,0,16,0,0.000,,
4,NA,62,2.5,3,2,9,9,21,0,18,0,0.000,,
4,NA,63,4,5,3,9,9,19,0,18,0,0.000,,
4,NA,64,3.5,3,4,10,10,20,0,20,0,0.000,,
4,NA,65,4.5,4,5,10,10,20,0,20,0,0.000,,
4,NA,66,3.5,3,4,11,11,23,0,22,0,0.000,,
4,NA,67,2.5,3,2,12,12,25,0,24,0,0.000,,
4,NA,68,4,5,3,12,12,24,0,24,0,0.000,,
4,NA,69,3.5,5,2,3,4,7,-1,7,-7,-0.012,,
4,NA,70,3.5,3,4,4,5,12,-1,9,-9,-0.016,,
4,NA,71,3,2,4,2,4,9,-2,6,-12,-0.021,,
4,NA,72,4.5,4,5,6,7,13,-1,13,-13,-0.023,,
4,NA,73,4.5,4,5,6,7,13,-1,13,-13,-0.023,,
4,NA,74,4,5,3,1,4,12,-3,5,-15,-0.026,,
4,NA,75,2.5,1,4,7,8,17,-1,15,-15,-0.026,,
4,NA,76,3.5,4,3,7,8,17,-1,15,-15,-0.026,,
4,NA,77,3.5,4,3,7,8,16,-1,15,-15,-0.026,,
4,NA,78,4.5,4,5,8,9,17,-1,17,-17,-0.030,,
4,NA,79,2.5,3,2,9,10,19,-1,19,-19,-0.033,,
4,NA,80,2.5,2,3,4,6,11,-2,10,-20,-0.035,,
4,NA,81,3.5,3,4,4,6,12,-2,10,-20,-0.035,,
4,NA,82,2.5,2,3,11,12,23,-1,23,-23,-0.040,,
4,NA,83,4,3,5,11,12,24,-1,23,-23,-0.040,,
4,NA,84,2.5,1,4,5,7,12,-2,12,-24,-0.042,,
4,NA,85,3.5,3,4,12,13,26,-1,25,-25,-0.043,,
4,NA,86,3.5,3,4,12,13,26,-1,25,-25,-0.043,,
4,NA,87,3.5,3,4,12,13,26,-1,25,-25,-0.043,,
4,NA,88,4,4,4,12,13,26,-1,25,-25,-0.043,,
4,NA,89,4.5,4,5,3,6,9,-3,9,-27,-0.047,,
4,NA,90,3,2,4,13,14,27,-1,27,-27,-0.047,,
4,NA,91,2.5,2,3,6,8,15,-2,14,-28,-0.049,,
4,NA,92,4,4,4,4,7,11,-3,11,-33,-0.057,,
4,NA,93,2.5,3,2,5,8,13,-3,13,-39,-0.068,,
4,NA,94,3,2,4,3,7,10,-4,10,-40,-0.069,,
4,NA,95,3.5,5,2,9,11,20,-2,20,-40,-0.069,,
4,NA,96,3.5,4,3,10,12,22,-2,22,-44,-0.076,,
4,NA,97,4,4,4,6,9,15,-3,15,-45,-0.078,,
4,NA,98,4,3,5,11,13,25,-2,24,-48,-0.083,,
4,NA,99,4,4,4,11,13,25,-2,24,-48,-0.083,,
4,NA,100,3.5,5,2,5,9,15,-4,14,-56,-0.097,,
4,NA,101,3,2,4,5,9,14,-4,14,-56,-0.097,,
4,NA,102,4.5,4,5,9,12,21,-3,21,-63,-0.109,,
4,NA,103,2.5,4,1,6,10,16,-4,16,-64,-0.111,,
4,NA,104,2.5,3,2,6,10,16,-4,16,-64,-0.111,,
4,NA,105,2.5,3,2,6,10,16,-4,16,-64,-0.111,,
4,NA,106,4.5,4,5,11,14,25,-3,25,-75,-0.130,,
4,NA,107,4,4,4,5,11,16,-6,16,-96,-0.167,,
4,NA,108,4,5,3,6,13,19,-7,19,-133,-0.231,,
4,NA,109,3.5,2,5,5,13,19,-8,18,-144,-0.250,,
5,NA,1,2,3,1,16,8,24,8,24,192,0.333,,
5,NA,2,3,2,4,15,9,24,6,24,144,0.250,,
5,NA,3,3,2,4,13,6,19,7,19,133,0.231,,
5,NA,4,3,3,3,12,4,17,8,16,128,0.222,,
5,NA,5,4.5,4,5,14,9,24,5,23,115,0.200,,
5,NA,6,4.5,5,4,12,5,17,7,17,119,0.207,,
5,NA,7,2.5,2,3,13,8,23,5,21,105,0.182,,
5,NA,8,2.5,2,3,14,10,24,4,24,96,0.167,,
5,NA,9,3,4,2,13,9,22,4,22,88,0.153,,
5,NA,10,3,2,4,16,13,29,3,29,87,0.151,,
5,NA,11,3.5,4,3,11,6,17,5,17,85,0.148,,
5,NA,12,2.5,3,2,15,12,27,3,27,81,0.141,,
5,NA,13,3.5,3,4,15,12,27,3,27,81,0.141,,
5,NA,14,3,1,5,14,11,25,3,25,75,0.130,,
5,NA,15,2.5,4,1,10,5,16,5,15,75,0.130,,
5,NA,16,3.5,3,4,14,11,25,3,25,75,0.130,,
5,NA,17,2.5,4,1,10,5,18,5,15,75,0.130,,
5,NA,18,3,3,3,11,7,18,4,18,72,0.125,,
5,NA,19,3.5,2,5,11,7,18,4,18,72,0.125,,
5,NA,20,2.5,2,3,11,7,18,4,18,72,0.125,,
5,NA,21,3.5,2,5,11,7,18,4,18,72,0.125,,
5,NA,22,3.5,4,3,13,10,23,3,23,69,0.120,,
5,NA,23,2.5,3,2,13,10,25,3,23,69,0.120,,
5,NA,24,3.5,3,4,12,9,21,3,21,63,0.109,,
5,NA,25,3,4,2,12,9,22,3,21,63,0.109,,
5,NA,26,3,2,4,12,9,21,3,21,63,0.109,,
5,NA,27,4,3,5,11,8,20,3,19,57,0.099,,
5,NA,28,3,3,3,9,5,14,4,14,56,0.097,,
5,NA,29,4,3,5,9,5,15,4,14,56,0.097,,
5,NA,30,4,5,3,9,5,16,4,14,56,0.097,,
5,NA,31,4,4,4,8,3,12,5,11,55,0.095,,
5,NA,32,3.5,4,3,10,7,17,3,17,51,0.089,,
5,NA,33,3.5,4,3,10,7,17,3,17,51,0.089,,
5,NA,34,2.5,2,3,8,4,12,4,12,48,0.083,,
5,NA,35,2.5,3,2,8,4,12,4,12,48,0.083,,
5,NA,36,3.5,3,4,8,4,12,4,12,48,0.083,,
5,NA,37,3,3,3,9,6,15,3,15,45,0.078,,
5,NA,38,3.5,4,3,9,6,15,3,15,45,0.078,,
5,NA,39,4.5,5,4,9,6,15,3,15,45,0.078,,
5,NA,40,2,2,2,12,10,22,2,22,44,0.076,,
5,NA,41,4.5,5,4,12,10,23,2,22,44,0.076,,
5,NA,42,4,4,4,12,10,22,2,22,44,0.076,,
5,NA,43,3.5,2,5,12,10,22,2,22,44,0.076,,
5,NA,44,4,4,4,7,3,11,4,10,40,0.069,,
5,NA,45,3.5,4,3,8,5,13,3,13,39,0.068,,
5,NA,46,3.5,3,4,10,8,18,2,18,36,0.063,,
5,NA,47,3,3,3,10,8,20,2,18,36,0.063,,
5,NA,48,3,4,2,10,8,18,2,18,36,0.063,,
5,NA,49,2,2,2,6,1,8,5,7,35,0.061,,
5,NA,50,2,3,1,7,4,11,3,11,33,0.057,,
5,NA,51,4,5,3,7,4,11,3,11,33,0.057,,
5,NA,52,3,2,4,9,7,17,2,16,32,0.056,,
5,NA,53,4,4,4,6,2,8,4,8,32,0.056,,
5,NA,54,2.5,3,2,9,7,17,2,16,32,0.056,,
5,NA,55,3.5,2,5,16,15,31,1,31,31,0.054,,
5,NA,56,4.5,5,4,8,6,15,2,14,28,0.049,,
5,NA,57,2.5,2,3,8,6,15,2,14,28,0.049,,
5,NA,58,3.5,5,2,8,6,15,2,14,28,0.049,,
5,NA,59,2.5,1,4,13,12,25,1,25,25,0.043,,
5,NA,60,3,3,3,13,12,26,1,25,25,0.043,,
5,NA,61,4,5,3,7,5,12,2,12,24,0.042,,
5,NA,62,3,2,4,12,11,24,1,23,23,0.040,,
5,NA,63,4,4,4,7,5,12,2,12,24,0.042,,
5,NA,64,3.5,2,5,7,5,14,2,12,24,0.042,,
5,NA,65,3.5,4,3,5,2,9,3,7,21,0.036,,
5,NA,66,2.5,4,1,11,10,21,1,21,21,0.036,,
5,NA,67,3.5,3,4,11,10,21,1,21,21,0.036,,
5,NA,68,3,3,3,5,2,7,3,7,21,0.036,,
5,NA,69,3,3,3,5,2,7,3,7,21,0.036,,
5,NA,70,2,2,2,6,4,10,2,10,20,0.035,,
5,NA,71,3,3,3,10,9,19,1,19,19,0.033,,
5,NA,72,1.5,1,2,10,9,20,1,19,19,0.033,,
5,NA,73,2,1,3,9,8,17,1,17,17,0.030,,
5,NA,74,2.5,3,2,9,8,18,1,17,17,0.030,,
5,NA,75,4,4,4,5,3,8,2,8,16,0.028,,
5,NA,76,3.5,4,3,5,3,8,2,8,16,0.028,,
5,NA,77,2,2,2,8,7,17,1,15,15,0.026,,
5,NA,78,2.5,2,3,8,7,15,1,15,15,0.026,,
5,NA,79,2,2,2,8,7,15,1,15,15,0.026,,
5,NA,80,3.5,5,2,8,7,15,1,15,15,0.026,,
5,NA,81,2,3,1,8,7,15,1,15,15,0.026,,
5,NA,82,3,3,3,8,7,15,1,15,15,0.026,,
5,NA,83,4,3,5,7,6,13,1,13,13,0.023,,
5,NA,84,1,1,1,7,6,14,1,13,13,0.023,,
5,NA,85,2.5,4,1,4,2,6,2,6,12,0.021,,
5,NA,86,2,3,1,6,5,11,1,11,11,0.019,,
5,NA,87,2.5,2,3,6,5,12,1,11,11,0.019,,
5,NA,88,4,4,4,5,4,9,1,9,9,0.016,,
5,NA,89,3,3,3,3,0,3,3,3,9,0.016,,
5,NA,90,3,2,4,5,4,9,1,9,9,0.016,,
5,NA,91,2,3,1,4,3,8,1,7,7,0.012,,
5,NA,92,3.5,4,3,3,2,5,1,5,5,0.009,,
5,NA,93,3,4,2,9,9,19,0,18,0,0.000,,
5,NA,94,2.5,3,2,4,4,8,0,8,0,0.000,,
5,NA,95,3,4,2,8,8,18,0,16,0,0.000,,
5,NA,96,2.5,3,2,11,11,22,0,22,0,0.000,,
5,NA,97,3,2,4,7,7,15,0,14,0,0.000,,
5,NA,98,2.5,3,2,14,14,28,0,28,0,0.000,,
5,NA,99,4,3,5,6,6,13,0,12,0,0.000,,
5,NA,100,3,3,3,13,13,26,0,26,0,0.000,,
5,NA,101,2.5,3,2,6,6,13,0,12,0,0.000,,
5,NA,102,3.5,3,4,9,9,18,0,18,0,0.000,,
5,NA,103,4,4,4,6,6,12,0,12,0,0.000,,
5,NA,104,3,2,4,7,7,15,0,14,0,0.000,,
5,NA,105,4,3,5,12,12,24,0,24,0,0.000,,
5,NA,106,3.5,3,4,0,0,0,0,0,0,0.000,,
5,NA,107,4,4,4,11,11,23,0,22,0,0.000,,
5,NA,108,1.5,2,1,9,9,20,0,18,0,0.000,,
5,NA,109,2.5,3,2,11,11,24,0,22,0,0.000,,
5,NA,110,3.5,3,4,7,7,14,0,14,0,0.000,,
5,NA,111,2,1,3,13,13,26,0,26,0,0.000,,
5,NA,112,3.5,3,4,4,4,9,0,8,0,0.000,,
5,NA,113,5,5,5,12,12,26,0,24,0,0.000,,
5,NA,114,2,2,2,4,4,8,0,8,0,0.000,,
5,NA,115,2,3,1,8,8,16,0,16,0,0.000,,
5,NA,116,4,4,4,12,12,24,0,24,0,0.000,,
5,NA,117,5,5,5,8,8,16,0,16,0,0.000,,
5,NA,118,3,2,4,2,2,4,0,4,0,0.000,,
5,NA,119,4,3,5,3,4,7,-1,7,-7,-0.012,,
5,NA,120,4,5,3,4,5,10,-1,9,-9,-0.016,,
5,NA,121,3,2,4,5,6,11,-1,11,-11,-0.019,,
5,NA,122,3.5,5,2,5,6,11,-1,11,-11,-0.019,,
5,NA,123,2.5,3,2,6,7,13,-1,13,-13,-0.023,,
5,NA,124,4,4,4,6,7,13,-1,13,-13,-0.023,,
5,NA,125,2.5,3,2,7,8,15,-1,15,-15,-0.026,,
5,NA,126,3.5,3,4,7,8,16,-1,15,-15,-0.026,,
5,NA,127,3,2,4,3,5,9,-2,8,-16,-0.028,,
5,NA,128,3,2,4,8,9,17,-1,17,-17,-0.030,,
5,NA,129,2.5,4,1,8,9,17,-1,17,-17,-0.030,,
5,NA,130,3.5,4,3,8,9,17,-1,17,-17,-0.030,,
5,NA,131,2,2,2,8,9,17,-1,17,-17,-0.030,,
5,NA,132,2.5,3,2,9,10,19,-1,19,-19,-0.033,,
5,NA,133,3,2,4,9,10,19,-1,19,-19,-0.033,,
5,NA,134,4,4,4,9,10,19,-1,19,-19,-0.033,,
5,NA,135,3.5,3,4,4,6,10,-2,10,-20,-0.035,,
5,NA,136,4,3,5,10,11,21,-1,21,-21,-0.036,,
5,NA,137,3.5,3,4,11,12,25,-1,23,-23,-0.040,,
5,NA,138,3,3,3,11,12,24,-1,23,-23,-0.040,,
5,NA,139,1.5,1,2,11,12,23,-1,23,-23,-0.040,,
5,NA,140,4,5,3,5,7,14,-2,12,-24,-0.042,,
5,NA,141,3.5,3,4,5,7,14,-2,12,-24,-0.042,,
5,NA,142,3.5,2,5,12,13,25,-1,25,-25,-0.043,,
5,NA,143,3.5,2,5,12,13,25,-1,25,-25,-0.043,,
5,NA,144,4,4,4,13,14,27,-1,27,-27,-0.047,,
5,NA,145,3,3,3,3,6,12,-3,9,-27,-0.047,,
5,NA,146,2,2,2,13,14,27,-1,27,-27,-0.047,,
5,NA,147,2.5,3,2,3,6,10,-3,9,-27,-0.047,,
5,NA,148,2.5,2,3,6,8,15,-2,14,-28,-0.049,,
5,NA,149,2.5,2,3,6,8,15,-2,14,-28,-0.049,,
5,NA,150,3.5,3,4,15,16,31,-1,31,-31,-0.054,,
5,NA,151,3,3,3,2,6,10,-4,8,-32,-0.056,,
5,NA,152,4,4,4,7,9,17,-2,16,-32,-0.056,,
5,NA,153,3.5,4,3,7,9,18,-2,16,-32,-0.056,,
5,NA,154,3,2,4,4,7,11,-3,11,-33,-0.057,,
5,NA,155,3,5,1,8,10,20,-2,18,-36,-0.063,,
5,NA,156,2.5,3,2,8,10,20,-2,18,-36,-0.063,,
5,NA,157,2.5,2,3,8,10,18,-2,18,-36,-0.063,,
5,NA,158,4,3,5,5,8,13,-3,13,-39,-0.068,,
5,NA,159,4,4,4,5,8,14,-3,13,-39,-0.068,,
5,NA,160,2.5,3,2,9,11,21,-2,20,-40,-0.069,,
5,NA,161,2.5,3,2,9,11,20,-2,20,-40,-0.069,,
5,NA,162,3.5,3,4,9,11,20,-2,20,-40,-0.069,,
5,NA,163,3,2,4,9,11,20,-2,20,-40,-0.069,,
5,NA,164,3,4,2,3,7,11,-4,10,-40,-0.069,,
5,NA,165,3.5,4,3,10,12,23,-2,22,-44,-0.076,,
5,NA,166,5,5,5,10,12,22,-2,22,-44,-0.076,,
5,NA,167,4,3,5,10,12,22,-2,22,-44,-0.076,,
5,NA,168,3,4,2,6,9,16,-3,15,-45,-0.078,,
5,NA,169,3.5,3,4,6,9,15,-3,15,-45,-0.078,,
5,NA,170,4,4,4,6,9,15,-3,15,-45,-0.078,,
5,NA,171,2.5,4,1,4,8,12,-4,12,-48,-0.083,,
5,NA,172,3,3,3,4,8,13,-4,12,-48,-0.083,,
5,NA,173,4,3,5,11,13,24,-2,24,-48,-0.083,,
5,NA,174,2,2,2,11,13,25,-2,24,-48,-0.083,,
5,NA,175,3.5,3,4,7,10,17,-3,17,-51,-0.089,,
5,NA,176,2,3,1,7,10,17,-3,17,-51,-0.089,,
5,NA,177,3,2,4,7,10,18,-3,17,-51,-0.089,,
5,NA,178,3,4,2,7,10,17,-3,17,-51,-0.089,,
5,NA,179,2,3,1,12,14,26,-2,26,-52,-0.090,,
5,NA,180,2.5,3,2,12,14,26,-2,26,-52,-0.090,,
5,NA,181,4.5,4,5,12,14,26,-2,26,-52,-0.090,,
5,NA,182,4,4,4,13,15,29,-2,28,-56,-0.097,,
5,NA,183,2,2,2,8,11,20,-3,19,-57,-0.099,,
5,NA,184,2.5,2,3,9,12,21,-3,21,-63,-0.109,,
5,NA,185,3.5,3,4,6,10,16,-4,16,-64,-0.111,,
5,NA,186,3.5,2,5,15,17,32,-2,32,-64,-0.111,,
5,NA,187,2.5,2,3,15,17,32,-2,32,-64,-0.111,,
5,NA,188,1.5,1,2,4,9,13,-5,13,-65,-0.113,,
5,NA,189,2,2,2,10,13,24,-3,23,-69,-0.120,,
5,NA,190,4.5,4,5,10,13,23,-3,23,-69,-0.120,,
5,NA,191,3,3,3,11,14,25,-3,25,-75,-0.130,,
5,NA,192,3,3,3,5,10,16,-5,15,-75,-0.130,,
5,NA,193,1.5,2,1,11,14,25,-3,25,-75,-0.130,,
5,NA,194,3,2,4,8,12,20,-4,20,-80,-0.139,,
5,NA,195,2,3,1,8,12,20,-4,20,-80,-0.139,,
5,NA,196,4,4,4,6,11,17,-5,17,-85,-0.148,,
5,NA,197,3.5,2,5,9,13,24,-4,22,-88,-0.153,,
5,NA,198,3,4,2,9,13,22,-4,22,-88,-0.153,,
5,NA,199,3,4,2,9,13,22,-4,22,-88,-0.153,,
5,NA,200,3.5,2,5,9,13,22,-4,22,-88,-0.153,,
5,NA,201,4,4,4,3,10,13,-7,13,-91,-0.158,,
5,NA,202,4,3,5,8,13,21,-5,21,-105,-0.182,,
5,NA,203,2.5,4,1,4,11,15,-7,15,-105,-0.182,,
5,NA,204,3,4,2,6,12,18,-6,18,-108,-0.188,,
5,NA,205,3.5,3,4,6,12,19,-6,18,-108,-0.188,,
5,NA,206,3.5,3,4,3,12,15,-9,15,-135,-0.234,,
5,NA,207,3,2,4,9,15,25,-6,24,-144,-0.250,,
5,NA,208,4.5,4,5,9,15,24,-6,24,-144,-0.250,,
5,NA,209,3,3,3,9,16,25,-7,25,-175,-0.304,,
5,NA,210,3.5,3,4,6,15,21,-9,21,-189,-0.328,,
5,NA,211,3,3,3,8,16,24,-8,24,-192,-0.333,,
6,test_before_practice,1,3.5,4,3,18,11,30,7,29,203,0.352,,
6,test_before_practice,2,4,3,5,15,10,27,5,25,125,0.217,,
6,test_before_practice,3,2.5,2,3,13,8,22,5,21,105,0.182,,
6,test_before_practice,4,3,3,3,17,14,31,3,31,93,0.161,,
6,test_before_practice,5,3,4,2,17,14,31,3,31,93,0.161,,
6,test_before_practice,6,2.5,4,1,10,4,14,6,14,84,0.146,,
6,test_before_practice,7,2,3,1,15,12,27,3,27,81,0.141,,
6,test_before_practice,8,3,1,5,13,10,24,3,23,69,0.120,,
6,test_before_practice,9,2,2,2,10,6,17,4,16,64,0.111,,
6,test_before_practice,10,4,4,4,16,14,32,2,30,60,0.104,,
6,test_before_practice,11,3,2,4,16,14,30,2,30,60,0.104,,
6,test_before_practice,12,3.5,4,3,11,8,19,3,19,57,0.099,,
6,test_before_practice,13,1.5,2,1,11,8,19,3,19,57,0.099,,
6,test_before_practice,14,3,3,3,9,5,14,4,14,56,0.097,,
6,test_before_practice,15,3.5,2,5,9,6,15,3,15,45,0.078,,
6,test_before_practice,16,4,4,4,9,6,16,3,15,45,0.078,,
6,test_before_practice,17,2.5,2,3,9,6,16,3,15,45,0.078,,
6,test_before_practice,18,3,2,4,12,10,22,2,22,44,0.076,,
6,test_before_practice,19,2.5,4,1,10,8,18,2,18,36,0.063,,
6,test_before_practice,20,5,5,5,9,7,16,2,16,32,0.056,,
6,test_before_practice,21,3,3,3,16,15,31,1,31,31,0.054,,
6,test_before_practice,22,4.5,4,5,15,14,30,1,29,29,0.050,,
6,test_before_practice,23,2.5,3,2,8,6,15,2,14,28,0.049,,
6,test_before_practice,24,3.5,3,4,7,5,12,2,12,24,0.042,,
6,test_before_practice,25,2,1,3,7,5,12,2,12,24,0.042,,
6,test_before_practice,26,3,2,4,12,11,24,1,23,23,0.040,,
6,test_before_practice,27,4.5,5,4,5,2,7,3,7,21,0.036,,
6,test_before_practice,28,3,2,4,9,8,17,1,17,17,0.030,,
6,test_before_practice,29,3,1,5,9,8,17,1,17,17,0.030,,
6,test_before_practice,30,2,3,1,8,7,15,1,15,15,0.026,,
6,test_before_practice,31,4,3,5,8,7,15,1,15,15,0.026,,
6,test_before_practice,32,4.5,4,5,4,2,6,2,6,12,0.021,,
6,test_before_practice,33,4,4,4,4,2,6,2,6,12,0.021,,
6,test_before_practice,34,2.5,3,2,3,2,6,1,5,5,0.009,,
6,test_before_practice,35,2,3,1,2,1,3,1,3,3,0.005,,
6,test_before_practice,36,3.5,4,3,2,1,7,1,3,3,0.005,,
6,test_before_practice,37,4.5,5,4,0,0,1,0,0,0,0.000,,
6,test_before_practice,38,2,2,2,0,0,0,0,0,0,0.000,,
6,test_before_practice,39,4,4,4,0,0,0,0,0,0,0.000,,
6,test_before_practice,40,4.5,4,5,0,0,0,0,0,0,0.000,,
6,test_before_practice,41,3,4,2,1,1,3,0,2,0,0.000,,
6,test_before_practice,42,2.5,4,1,2,2,4,0,4,0,0.000,,
6,test_before_practice,43,4.5,5,4,2,2,4,0,4,0,0.000,,
6,test_before_practice,44,3,1,5,4,4,9,0,8,0,0.000,,
6,test_before_practice,45,2.5,3,2,5,5,10,0,10,0,0.000,,
6,test_before_practice,46,2,2,2,5,5,10,0,10,0,0.000,,
6,test_before_practice,47,3,3,3,6,6,12,0,12,0,0.000,,
6,test_before_practice,48,3,4,2,8,8,17,0,16,0,0.000,,
6,test_before_practice,49,4.5,4,5,9,9,18,0,18,0,0.000,,
6,test_before_practice,50,3,2,4,10,10,20,0,20,0,0.000,,
6,test_before_practice,51,4.5,4,5,10,10,20,0,20,0,0.000,,
6,test_before_practice,52,4,4,4,10,10,20,0,20,0,0.000,,
6,test_before_practice,53,3,3,3,10,10,20,0,20,0,0.000,,
6,test_before_practice,54,3,3,3,12,12,24,0,24,0,0.000,,
6,test_before_practice,55,3,1,5,13,13,26,0,26,0,0.000,,
6,test_before_practice,56,2,2,2,13,13,26,0,26,0,0.000,,
6,test_before_practice,57,2.5,3,2,14,14,29,0,28,0,0.000,,
6,test_before_practice,58,4,4,4,14,14,28,0,28,0,0.000,,
6,test_before_practice,59,3.5,4,3,14,14,29,0,28,0,0.000,,
6,test_before_practice,60,3.5,2,5,16,16,32,0,32,0,0.000,,
6,test_before_practice,61,3.5,2,5,1,2,3,-1,3,-3,-0.005,,
6,test_before_practice,62,5,5,5,0,2,3,-2,2,-4,-0.007,,
6,test_before_practice,63,5,5,5,0,2,4,-2,2,-4,-0.007,,
6,test_before_practice,64,3,3,3,1,3,6,-2,4,-8,-0.014,,
6,test_before_practice,65,2.5,3,2,1,3,4,-2,4,-8,-0.014,,
6,test_before_practice,66,3,2,4,0,3,3,-3,3,-9,-0.016,,
6,test_before_practice,67,4.5,4,5,4,5,10,-1,9,-9,-0.016,,
6,test_before_practice,68,4.5,5,4,4,5,10,-1,9,-9,-0.016,,
6,test_before_practice,69,5,5,5,5,6,11,-1,11,-11,-0.019,,
6,test_before_practice,70,2,2,2,6,7,13,-1,13,-13,-0.023,,
6,test_before_practice,71,3.5,3,4,6,7,13,-1,13,-13,-0.023,,
6,test_before_practice,72,2,2,2,6,7,14,-1,13,-13,-0.023,,
6,test_before_practice,73,3.5,2,5,1,4,5,-3,5,-15,-0.026,,
6,test_before_practice,74,3.5,2,5,8,9,17,-1,17,-17,-0.030,,
6,test_before_practice,75,3.5,3,4,8,9,17,-1,17,-17,-0.030,,
6,test_before_practice,76,3.5,4,3,4,6,10,-2,10,-20,-0.035,,
6,test_before_practice,77,1.5,2,1,4,6,10,-2,10,-20,-0.035,,
6,test_before_practice,78,3,3,3,4,6,10,-2,10,-20,-0.035,,
6,test_before_practice,79,3,3,3,2,5,7,-3,7,-21,-0.036,,
6,test_before_practice,80,3.5,3,4,10,11,21,-1,21,-21,-0.036,,
6,test_before_practice,81,2.5,3,2,10,11,21,-1,21,-21,-0.036,,
6,test_before_practice,82,1.5,2,1,5,7,14,-2,12,-24,-0.042,,
6,test_before_practice,83,2,1,3,12,13,26,-1,25,-25,-0.043,,
6,test_before_practice,84,3,4,2,12,13,26,-1,25,-25,-0.043,,
6,test_before_practice,85,3,4,2,6,8,14,-2,14,-28,-0.049,,
6,test_before_practice,86,4,3,5,13,14,28,-1,27,-27,-0.047,,
6,test_before_practice,87,4,5,3,2,6,11,-4,8,-32,-0.056,,
6,test_before_practice,88,4,4,4,9,11,20,-2,20,-40,-0.069,,
6,test_before_practice,89,5,5,5,10,12,22,-2,22,-44,-0.076,,
6,test_before_practice,90,4,3,5,6,9,16,-3,15,-45,-0.078,,
6,test_before_practice,91,4,3,5,6,9,16,-3,15,-45,-0.078,,
6,test_before_practice,92,3,2,4,6,9,15,-3,15,-45,-0.078,,
6,test_before_practice,93,3,2,4,6,9,17,-3,15,-45,-0.078,,
6,test_before_practice,94,3.5,5,2,7,10,18,-3,17,-51,-0.089,,
6,test_before_practice,95,2,2,2,2,8,11,-6,10,-60,-0.104,,
6,test_before_practice,96,3,4,2,6,10,16,-4,16,-64,-0.111,,
6,test_before_practice,97,2.5,3,2,11,14,26,-3,25,-75,-0.130,,
6,test_before_practice,98,2.5,2,3,6,11,17,-5,17,-85,-0.148,,
6,test_before_practice,99,4,4,4,9,13,23,-4,22,-88,-0.153,,
6,test_before_practice,100,1.5,1,2,7,12,20,-5,19,-95,-0.165,,
6,test_before_practice,101,3,2,4,10,14,26,-4,24,-96,-0.167,,
6,test_before_practice,102,2.5,3,2,8,13,22,-5,21,-105,-0.182,,
6,test_before_practice,103,3,2,4,8,13,21,-5,21,-105,-0.182,,
6,test_before_practice,104,3.5,3,4,16,19,35,-3,35,-105,-0.182,,
6,test_before_practice,105,2,2,2,4,12,16,-8,16,-128,-0.222,,
6,test_before_practice,106,2.5,4,1,4,13,19,-9,17,-153,-0.266,,
6,practice_before_test,107,4,4,4,23,5,28,18,28,504,0.875,,
6,practice_before_test,108,3,3,3,22,4,26,18,26,468,0.813,,
6,practice_before_test,109,3,4,2,22,7,30,15,29,435,0.755,,
6,practice_before_test,110,2,2,2,21,3,24,18,24,432,0.750,,
6,practice_before_test,111,3.5,3,4,22,11,38,11,33,363,0.630,,
6,practice_before_test,112,4.5,4,5,21,6,27,15,27,405,0.703,,
6,practice_before_test,113,3.5,4,3,20,5,27,15,25,375,0.651,,
6,practice_before_test,114,2,1,3,20,4,24,16,24,384,0.667,,
6,practice_before_test,115,2.5,3,2,20,6,26,14,26,364,0.632,,
6,practice_before_test,116,3,2,4,22,11,33,11,33,363,0.630,,
6,practice_before_test,117,4,4,4,19,0,19,19,19,361,0.627,,
6,practice_before_test,118,4,4,4,21,9,30,12,30,360,0.625,,
6,practice_before_test,119,3,5,1,19,3,23,16,22,352,0.611,,
6,practice_before_test,120,4.5,5,4,19,3,22,16,22,352,0.611,,
6,practice_before_test,121,3,1,5,20,7,27,13,27,351,0.609,,
6,practice_before_test,122,3.5,3,4,19,4,23,15,23,345,0.599,,
6,practice_before_test,123,2,1,3,18,0,20,18,18,324,0.563,,
6,practice_before_test,124,4,5,3,19,5,24,14,24,336,0.583,,
6,practice_before_test,125,2.5,2,3,19,6,25,13,25,325,0.564,,
6,practice_before_test,126,3,4,2,19,6,25,13,25,325,0.564,,
6,practice_before_test,127,3.5,3,4,18,0,18,18,18,324,0.563,,
6,practice_before_test,128,2,3,1,18,0,18,18,18,324,0.563,,
6,practice_before_test,129,3.5,3,4,18,2,21,16,20,320,0.556,,
6,practice_before_test,130,3.5,3,4,18,2,20,16,20,320,0.556,,
6,practice_before_test,131,4,4,4,18,4,22,14,22,308,0.535,,
6,practice_before_test,132,1.5,1,2,17,1,19,16,18,288,0.500,,
6,practice_before_test,133,5,5,5,18,6,26,12,24,288,0.500,,
6,practice_before_test,134,2,1,3,18,5,25,13,23,299,0.519,,
6,practice_before_test,135,3,2,4,21,12,33,9,33,297,0.516,,
6,practice_before_test,136,3,1,5,17,0,18,17,17,289,0.502,,
6,practice_before_test,137,3.5,3,4,17,2,19,15,19,285,0.495,,
6,practice_before_test,138,4,4,4,17,2,19,15,19,285,0.495,,
6,practice_before_test,139,4.5,4,5,17,2,19,15,19,285,0.495,,
6,practice_before_test,140,4,3,5,17,5,25,12,22,264,0.458,,
6,practice_before_test,141,2,3,1,17,5,22,12,22,264,0.458,,
6,practice_before_test,142,2.5,2,3,15,0,15,15,15,225,0.391,,
6,practice_before_test,143,4.5,4,5,15,2,18,13,17,221,0.384,,
6,practice_before_test,144,3,5,1,15,2,17,13,17,221,0.384,,
6,practice_before_test,145,3.5,3,4,15,2,17,13,17,221,0.384,,
6,practice_before_test,146,3.5,2,5,15,3,18,12,18,216,0.375,,
6,practice_before_test,147,4.5,4,5,18,11,29,7,29,203,0.352,,
6,practice_before_test,148,3.5,5,2,15,5,20,10,20,200,0.347,,
6,practice_before_test,149,3.5,4,3,14,0,15,14,14,196,0.340,,
6,practice_before_test,150,2.5,2,3,14,1,15,13,15,195,0.339,,
6,practice_before_test,151,3,2,4,14,4,19,10,18,180,0.313,,
6,practice_before_test,152,5,5,5,15,6,21,9,21,189,0.328,,
6,practice_before_test,153,2.5,1,4,14,3,18,11,17,187,0.325,,
6,practice_before_test,154,3.5,3,4,14,5,19,9,19,171,0.297,,
6,practice_before_test,155,3.5,5,2,13,0,16,13,13,169,0.293,,
6,practice_before_test,156,2,3,1,13,3,16,10,16,160,0.278,,
6,practice_before_test,157,2.5,3,2,13,3,16,10,16,160,0.278,,
6,practice_before_test,158,4.5,4,5,21,17,39,4,38,152,0.264,,
6,practice_before_test,159,3.5,3,4,13,4,17,9,17,153,0.266,,
6,practice_before_test,160,3.5,3,4,12,0,12,12,12,144,0.250,,
6,practice_before_test,161,2.5,3,2,12,2,14,10,14,140,0.243,,
6,practice_before_test,162,3,2,4,12,2,16,10,14,140,0.243,,
6,practice_before_test,163,4,4,4,11,2,13,9,13,117,0.203,,
6,practice_before_test,164,4,5,3,21,18,40,3,39,117,0.203,,
6,practice_before_test,165,2.5,3,2,10,0,10,10,10,100,0.174,,
6,practice_before_test,166,3,3,3,10,1,11,9,11,99,0.172,,
6,practice_before_test,167,3.5,2,5,10,4,14,6,14,84,0.146,,
6,practice_before_test,168,2,2,2,9,2,11,7,11,77,0.134,,
6,practice_before_test,169,3,2,4,8,0,8,8,8,64,0.111,,
6,practice_before_test,170,4,3,5,7,0,7,7,7,49,0.085,,
6,practice_before_test,171,4.5,4,5,5,0,5,5,5,25,0.043,,
6,practice_before_test,172,4.5,4,5,5,0,5,5,5,25,0.043,,
6,practice_before_test,173,3,2,4,5,0,5,5,5,25,0.043,,
6,practice_before_test,174,3.5,4,3,3,0,4,3,3,9,0.016,,
6,practice_before_test,175,4.5,4,5,0,0,0,0,0,0,0.000,,
7,NA,1,2,2,2,22,11,48,11,33,363,0.630,,
7,NA,2,3,3,3,18,5,27,13,23,299,0.519,,
7,NA,3,3,3,3,19,8,31,11,27,297,0.516,,
7,NA,4,3,5,1,19,8,31,11,27,297,0.516,,
7,NA,5,3,4,2,20,12,43,8,32,256,0.444,,
7,NA,6,1.5,2,1,18,9,31,9,27,243,0.422,,
7,NA,7,3,2,4,19,11,32,8,30,240,0.417,,
7,NA,8,3.5,5,2,21,15,37,6,36,216,0.375,,
7,NA,9,4.5,4,5,20,14,38,6,34,204,0.354,,
7,NA,10,3,4,2,20,14,36,6,34,204,0.354,,
7,NA,11,3.5,3,4,18,11,31,7,29,203,0.352,,
7,NA,12,2.5,2,3,15,5,21,10,20,200,0.347,,
7,NA,13,3.5,2,5,16,8,26,8,24,192,0.333,,
7,NA,14,3,4,2,16,8,25,8,24,192,0.333,,
7,NA,15,2,3,1,17,10,39,7,27,189,0.328,,
7,NA,16,3,2,4,15,6,22,9,21,189,0.328,,
7,NA,17,4.5,5,4,18,12,31,6,30,180,0.313,,
7,NA,18,3,3,3,18,12,30,6,30,180,0.313,,
7,NA,19,4,5,3,15,7,24,8,22,176,0.306,,
7,NA,20,4,5,3,16,9,27,7,25,175,0.304,,
7,NA,21,2.5,3,2,20,15,37,5,35,175,0.304,,
7,NA,22,4,3,5,16,9,28,7,25,175,0.304,,
7,NA,23,2,2,2,16,9,27,7,25,175,0.304,,
7,NA,24,3.5,2,5,15,8,31,7,23,161,0.280,,
7,NA,25,3,4,2,15,8,24,7,23,161,0.280,,
7,NA,26,2,3,1,14,6,22,8,20,160,0.278,,
7,NA,27,1.5,2,1,16,10,31,6,26,156,0.271,,
7,NA,28,2.5,1,4,16,10,28,6,26,156,0.271,,
7,NA,29,4,4,4,18,13,32,5,31,155,0.269,,
7,NA,30,4,3,5,21,17,41,4,38,152,0.264,,
7,NA,31,2.5,1,4,14,7,24,7,21,147,0.255,,
7,NA,32,3.5,5,2,14,7,24,7,21,147,0.255,,
7,NA,33,3,4,2,14,7,23,7,21,147,0.255,,
7,NA,34,2,3,1,14,7,24,7,21,147,0.255,,
7,NA,35,1.5,2,1,14,7,22,7,21,147,0.255,,
7,NA,36,4,4,4,17,12,31,5,29,145,0.252,,
7,NA,37,3,4,2,13,5,19,8,18,144,0.250,,
7,NA,38,2.5,3,2,15,9,25,6,24,144,0.250,,
7,NA,39,2,1,3,15,9,24,6,24,144,0.250,,
7,NA,40,4,3,5,13,5,18,8,18,144,0.250,,
7,NA,41,2.5,3,2,15,9,28,6,24,144,0.250,,
7,NA,42,2.5,3,2,15,9,24,6,24,144,0.250,,
7,NA,43,4,4,4,15,9,25,6,24,144,0.250,,
7,NA,44,2.5,4,1,15,9,24,6,24,144,0.250,,
7,NA,45,2,1,3,15,9,25,6,24,144,0.250,,
7,NA,46,3,4,2,15,9,27,6,24,144,0.250,,
7,NA,47,4,5,3,15,9,25,6,24,144,0.250,,
7,NA,48,3,4,2,19,15,34,4,34,136,0.236,,
7,NA,49,3,4,2,19,15,37,4,34,136,0.236,,
7,NA,50,3.5,3,4,19,15,37,4,34,136,0.236,,
7,NA,51,1.5,1,2,16,11,29,5,27,135,0.234,,
7,NA,52,1.5,1,2,16,11,30,5,27,135,0.234,,
7,NA,53,2.5,3,2,16,11,29,5,27,135,0.234,,
7,NA,54,3,2,4,16,11,28,5,27,135,0.234,,
7,NA,55,2,3,1,13,6,20,7,19,133,0.231,,
7,NA,56,3.5,2,5,13,6,20,7,19,133,0.231,,
7,NA,57,3,2,4,13,6,22,7,19,133,0.231,,
7,NA,58,1,1,1,13,6,21,7,19,133,0.231,,
7,NA,59,2.5,3,2,13,6,22,7,19,133,0.231,,
7,NA,60,4.5,4,5,14,8,23,6,22,132,0.229,,
7,NA,61,3,3,3,14,8,25,6,22,132,0.229,,
7,NA,62,2.5,2,3,14,8,24,6,22,132,0.229,,
7,NA,63,2.5,1,4,14,8,26,6,22,132,0.229,,
7,NA,64,4,3,5,14,8,27,6,22,132,0.229,,
7,NA,65,3.5,3,4,14,8,27,6,22,132,0.229,,
7,NA,66,2.5,3,2,14,8,24,6,22,132,0.229,,
7,NA,67,3,2,4,18,14,36,4,32,128,0.222,,
7,NA,68,2,3,1,15,10,26,5,25,125,0.217,,
7,NA,69,3.5,4,3,15,10,26,5,25,125,0.217,,
7,NA,70,2,3,1,15,10,27,5,25,125,0.217,,
7,NA,71,4.5,4,5,15,10,26,5,25,125,0.217,,
7,NA,72,3,2,4,15,10,27,5,25,125,0.217,,
7,NA,73,3.5,3,4,15,10,26,5,25,125,0.217,,
7,NA,74,2,2,2,15,10,28,5,25,125,0.217,,
7,NA,75,2.5,2,3,22,19,43,3,41,123,0.214,,
7,NA,76,2.5,2,3,17,13,33,4,30,120,0.208,,
7,NA,77,3,4,2,17,13,31,4,30,120,0.208,,
7,NA,78,2.5,1,4,17,13,31,4,30,120,0.208,,
7,NA,79,1,1,1,13,7,23,6,20,120,0.208,,
7,NA,80,3.5,4,3,13,7,22,6,20,120,0.208,,
7,NA,81,4.5,4,5,13,7,23,6,20,120,0.208,,
7,NA,82,2,2,2,13,7,20,6,20,120,0.208,,
7,NA,83,3.5,4,3,13,7,21,6,20,120,0.208,,
7,NA,84,2,2,2,13,7,22,6,20,120,0.208,,
7,NA,85,3,3,3,12,5,21,7,17,119,0.207,,
7,NA,86,2.5,1,4,12,5,20,7,17,119,0.207,,
7,NA,87,1.5,2,1,12,5,18,7,17,119,0.207,,
7,NA,88,3,3,3,12,5,23,7,17,119,0.207,,
7,NA,89,3,2,4,12,5,17,7,17,119,0.207,,
7,NA,90,2.5,3,2,12,5,18,7,17,119,0.207,,
7,NA,91,2.5,3,2,12,5,20,7,17,119,0.207,,
7,NA,92,4.5,5,4,11,2,13,9,13,117,0.203,,
7,NA,93,3,4,2,14,9,24,5,23,115,0.200,,
7,NA,94,4.5,5,4,14,9,23,5,23,115,0.200,,
7,NA,95,4.5,4,5,14,9,24,5,23,115,0.200,,
7,NA,96,2,2,2,14,9,24,5,23,115,0.200,,
7,NA,97,3,3,3,14,9,27,5,23,115,0.200,,
7,NA,98,2.5,4,1,14,9,24,5,23,115,0.200,,
7,NA,99,3.5,4,3,14,9,23,5,23,115,0.200,,
7,NA,100,2,3,1,14,9,25,5,23,115,0.200,,
7,NA,101,3,4,2,16,12,29,4,28,112,0.194,,
7,NA,102,4.5,5,4,16,12,30,4,28,112,0.194,,
7,NA,103,2.5,2,3,16,12,30,4,28,112,0.194,,
7,NA,104,1,1,1,16,12,30,4,28,112,0.194,,
7,NA,105,4,5,3,16,12,29,4,28,112,0.194,,
7,NA,106,3,4,2,16,12,29,4,28,112,0.194,,
7,NA,107,4,5,3,12,6,19,6,18,108,0.188,,
7,NA,108,4.5,5,4,12,6,19,6,18,108,0.188,,
7,NA,109,2,1,3,12,6,21,6,18,108,0.188,,
7,NA,110,4,4,4,12,6,18,6,18,108,0.188,,
7,NA,111,2.5,4,1,12,6,19,6,18,108,0.188,,
7,NA,112,3,3,3,12,6,19,6,18,108,0.188,,
7,NA,113,2,3,1,13,8,23,5,21,105,0.182,,
7,NA,114,2,2,2,11,4,17,7,15,105,0.182,,
7,NA,115,3,1,5,13,8,21,5,21,105,0.182,,
7,NA,116,4,3,5,13,8,22,5,21,105,0.182,,
7,NA,117,4,4,4,13,8,23,5,21,105,0.182,,
7,NA,118,2.5,2,3,13,8,24,5,21,105,0.182,,
7,NA,119,3.5,4,3,13,8,22,5,21,105,0.182,,
7,NA,120,2.5,1,4,13,8,23,5,21,105,0.182,,
7,NA,121,2,3,1,13,8,22,5,21,105,0.182,,
7,NA,122,3.5,4,3,13,8,24,5,21,105,0.182,,
7,NA,123,2.5,2,3,13,8,22,5,21,105,0.182,,
7,NA,124,2.5,4,1,13,8,23,5,21,105,0.182,,
7,NA,125,1,1,1,13,8,22,5,21,105,0.182,,
7,NA,126,2,2,2,13,8,21,5,21,105,0.182,,
7,NA,127,1,1,1,13,8,22,5,21,105,0.182,,
7,NA,128,3,3,3,13,8,25,5,21,105,0.182,,
7,NA,129,3,2,4,15,11,26,4,26,104,0.181,,
7,NA,130,2.5,2,3,15,11,29,4,26,104,0.181,,
7,NA,131,3,4,2,15,11,28,4,26,104,0.181,,
7,NA,132,3.5,5,2,15,11,29,4,26,104,0.181,,
7,NA,133,2.5,4,1,15,11,26,4,26,104,0.181,,
7,NA,134,4,5,3,15,11,28,4,26,104,0.181,,
7,NA,135,3,4,2,15,11,28,4,26,104,0.181,,
7,NA,136,1,1,1,15,11,28,4,26,104,0.181,,
7,NA,137,2.5,1,4,15,11,30,4,26,104,0.181,,
7,NA,138,2,3,1,18,15,34,3,33,99,0.172,,
7,NA,139,2,1,3,18,15,35,3,33,99,0.172,,
7,NA,140,3.5,4,3,18,15,34,3,33,99,0.172,,
7,NA,141,3,2,4,18,15,36,3,33,99,0.172,,
7,NA,142,3,4,2,14,10,25,4,24,96,0.167,,
7,NA,143,3.5,3,4,11,5,19,6,16,96,0.167,,
7,NA,144,3.5,4,3,11,5,18,6,16,96,0.167,,
7,NA,145,4,4,4,11,5,16,6,16,96,0.167,,
7,NA,146,4.5,4,5,14,10,24,4,24,96,0.167,,
7,NA,147,2.5,3,2,14,10,24,4,24,96,0.167,,
7,NA,148,3,2,4,11,5,19,6,16,96,0.167,,
7,NA,149,3,3,3,14,10,24,4,24,96,0.167,,
7,NA,150,2,3,1,14,10,26,4,24,96,0.167,,
7,NA,151,3,3,3,14,10,28,4,24,96,0.167,,
7,NA,152,2,2,2,14,10,25,4,24,96,0.167,,
7,NA,153,3.5,5,2,14,10,25,4,24,96,0.167,,
7,NA,154,3,2,4,14,10,28,4,24,96,0.167,,
7,NA,155,3,5,1,14,10,28,4,24,96,0.167,,
7,NA,156,3,3,3,14,10,30,4,24,96,0.167,,
7,NA,157,3,4,2,14,10,26,4,24,96,0.167,,
7,NA,158,3.5,4,3,12,7,20,5,19,95,0.165,,
7,NA,159,2,3,1,12,7,20,5,19,95,0.165,,
7,NA,160,1,1,1,12,7,20,5,19,95,0.165,,
7,NA,161,2.5,3,2,12,7,22,5,19,95,0.165,,
7,NA,162,2.5,3,2,12,7,20,5,19,95,0.165,,
7,NA,163,2.5,3,2,12,7,21,5,19,95,0.165,,
7,NA,164,3,5,1,12,7,21,5,19,95,0.165,,
7,NA,165,4,5,3,12,7,20,5,19,95,0.165,,
7,NA,166,2,3,1,12,7,23,5,19,95,0.165,,
7,NA,167,2,2,2,12,7,24,5,19,95,0.165,,
7,NA,168,4.5,4,5,17,14,32,3,31,93,0.161,,
7,NA,169,3.5,4,3,17,14,34,3,31,93,0.161,,
7,NA,170,2.5,3,2,17,14,34,3,31,93,0.161,,
7,NA,171,1.5,2,1,17,14,32,3,31,93,0.161,,
7,NA,172,4.5,4,5,10,3,14,7,13,91,0.158,,
7,NA,173,1.5,1,2,10,3,20,7,13,91,0.158,,
7,NA,174,2,3,1,10,3,14,7,13,91,0.158,,
7,NA,175,3.5,4,3,13,9,28,4,22,88,0.153,,
7,NA,176,2.5,3,2,13,9,23,4,22,88,0.153,,
7,NA,177,2.5,3,2,13,9,24,4,22,88,0.153,,
7,NA,178,3.5,5,2,13,9,26,4,22,88,0.153,,
7,NA,179,2.5,3,2,13,9,23,4,22,88,0.153,,
7,NA,180,4,4,4,13,9,24,4,22,88,0.153,,
7,NA,181,3.5,3,4,13,9,23,4,22,88,0.153,,
7,NA,182,2.5,1,4,13,9,22,4,22,88,0.153,,
7,NA,183,3.5,3,4,13,9,24,4,22,88,0.153,,
7,NA,184,2.5,4,1,13,9,25,4,22,88,0.153,,
7,NA,185,2.5,3,2,13,9,24,4,22,88,0.153,,
7,NA,186,2,2,2,13,9,23,4,22,88,0.153,,
7,NA,187,4,4,4,13,9,22,4,22,88,0.153,,
7,NA,188,3.5,4,3,16,13,32,3,29,87,0.151,,
7,NA,189,3,2,4,16,13,32,3,29,87,0.151,,
7,NA,190,3.5,4,3,16,13,30,3,29,87,0.151,,
7,NA,191,3,5,1,16,13,30,3,29,87,0.151,,
7,NA,192,2,1,3,16,13,31,3,29,87,0.151,,
7,NA,193,2.5,1,4,16,13,31,3,29,87,0.151,,
7,NA,194,2,2,2,11,6,17,5,17,85,0.148,,
7,NA,195,2.5,4,1,11,6,17,5,17,85,0.148,,
7,NA,196,3,3,3,11,6,18,5,17,85,0.148,,
7,NA,197,1.5,2,1,11,6,18,5,17,85,0.148,,
7,NA,198,2.5,4,1,11,6,17,5,17,85,0.148,,
7,NA,199,2,2,2,11,6,20,5,17,85,0.148,,
7,NA,200,3.5,5,2,11,6,19,5,17,85,0.148,,
7,NA,201,2.5,4,1,11,6,18,5,17,85,0.148,,
7,NA,202,2.5,4,1,11,6,18,5,17,85,0.148,,
7,NA,203,3.5,3,4,11,6,17,5,17,85,0.148,,
7,NA,204,2.5,3,2,10,4,14,6,14,84,0.146,,
7,NA,205,3,4,2,10,4,15,6,14,84,0.146,,
7,NA,206,2.5,4,1,10,4,17,6,14,84,0.146,,
7,NA,207,3,2,4,15,12,29,3,27,81,0.141,,
7,NA,208,3,3,3,15,12,31,3,27,81,0.141,,
7,NA,209,3.5,4,3,15,12,28,3,27,81,0.141,,
7,NA,210,4,3,5,15,12,29,3,27,81,0.141,,
7,NA,211,3.5,4,3,15,12,29,3,27,81,0.141,,
7,NA,212,3,2,4,12,8,20,4,20,80,0.139,,
7,NA,213,3.5,3,4,12,8,20,4,20,80,0.139,,
7,NA,214,3,2,4,12,8,21,4,20,80,0.139,,
7,NA,215,4.5,5,4,12,8,23,4,20,80,0.139,,
7,NA,216,2.5,3,2,12,8,21,4,20,80,0.139,,
7,NA,217,2.5,4,1,12,8,22,4,20,80,0.139,,
7,NA,218,2,1,3,12,8,22,4,20,80,0.139,,
7,NA,219,1,1,1,12,8,21,4,20,80,0.139,,
7,NA,220,3,4,2,12,8,20,4,20,80,0.139,,
7,NA,221,4,5,3,12,8,25,4,20,80,0.139,,
7,NA,222,5,5,5,12,8,22,4,20,80,0.139,,
7,NA,223,2.5,4,1,12,8,20,4,20,80,0.139,,
7,NA,224,2.5,4,1,12,8,22,4,20,80,0.139,,
7,NA,225,3.5,4,3,12,8,22,4,20,80,0.139,,
7,NA,226,3.5,5,2,12,8,20,4,20,80,0.139,,
7,NA,227,5,5,5,12,8,22,4,20,80,0.139,,
7,NA,228,1.5,2,1,12,8,21,4,20,80,0.139,,
7,NA,229,2.5,4,1,12,8,21,4,20,80,0.139,,
7,NA,230,3.5,4,3,10,5,16,5,15,75,0.130,,
7,NA,231,3,2,4,14,11,27,3,25,75,0.130,,
7,NA,232,1.5,1,2,14,11,26,3,25,75,0.130,,
7,NA,233,3.5,5,2,10,5,15,5,15,75,0.130,,
7,NA,234,2.5,2,3,14,11,28,3,25,75,0.130,,
7,NA,235,3.5,2,5,14,11,26,3,25,75,0.130,,
7,NA,236,4,4,4,10,5,15,5,15,75,0.130,,
7,NA,237,3,4,2,10,5,15,5,15,75,0.130,,
7,NA,238,4.5,4,5,14,11,26,3,25,75,0.130,,
7,NA,239,3,5,1,14,11,25,3,25,75,0.130,,
7,NA,240,3,2,4,14,11,27,3,25,75,0.130,,
7,NA,241,1,1,1,14,11,27,3,25,75,0.130,,
7,NA,242,2.5,2,3,10,5,16,5,15,75,0.130,,
7,NA,243,4,4,4,14,11,29,3,25,75,0.130,,
7,NA,244,2.5,4,1,14,11,27,3,25,75,0.130,,
7,NA,245,4,3,5,10,5,19,5,15,75,0.130,,
7,NA,246,4,3,5,10,5,18,5,15,75,0.130,,
7,NA,247,2.5,1,4,14,11,29,3,25,75,0.130,,
7,NA,248,2.5,4,1,14,11,28,3,25,75,0.130,,
7,NA,249,3,4,2,14,11,33,3,25,75,0.130,,
7,NA,250,2,3,1,14,11,26,3,25,75,0.130,,
7,NA,251,4,4,4,14,11,27,3,25,75,0.130,,
7,NA,252,3,3,3,14,11,28,3,25,75,0.130,,
7,NA,253,2,3,1,11,7,19,4,18,72,0.125,,
7,NA,254,3,4,2,19,17,37,2,36,72,0.125,,
7,NA,255,3,3,3,11,7,19,4,18,72,0.125,,
7,NA,256,2.5,2,3,11,7,20,4,18,72,0.125,,
7,NA,257,5,5,5,9,3,13,6,12,72,0.125,,
7,NA,258,4,4,4,11,7,19,4,18,72,0.125,,
7,NA,259,4.5,4,5,19,17,39,2,36,72,0.125,,
7,NA,260,2.5,3,2,11,7,22,4,18,72,0.125,,
7,NA,261,4.5,4,5,11,7,20,4,18,72,0.125,,
7,NA,262,3.5,3,4,11,7,22,4,18,72,0.125,,
7,NA,263,3.5,2,5,11,7,19,4,18,72,0.125,,
7,NA,264,3,4,2,11,7,18,4,18,72,0.125,,
7,NA,265,1.5,1,2,9,3,13,6,12,72,0.125,,
7,NA,266,2,2,2,11,7,18,4,18,72,0.125,,
7,NA,267,2,3,1,11,7,21,4,18,72,0.125,,
7,NA,268,4,4,4,11,7,19,4,18,72,0.125,,
7,NA,269,4,3,5,11,7,20,4,18,72,0.125,,
7,NA,270,2.5,2,3,11,7,18,4,18,72,0.125,,
7,NA,271,3.5,3,4,11,7,19,4,18,72,0.125,,
7,NA,272,3,3,3,11,7,21,4,18,72,0.125,,
7,NA,273,2,1,3,11,7,24,4,18,72,0.125,,
7,NA,274,2,3,1,11,7,19,4,18,72,0.125,,
7,NA,275,3,4,2,11,7,18,4,18,72,0.125,,
7,NA,276,3.5,4,3,13,10,23,3,23,69,0.120,,
7,NA,277,3,2,4,13,10,24,3,23,69,0.120,,
7,NA,278,3.5,2,5,13,10,29,3,23,69,0.120,,
7,NA,279,2.5,2,3,13,10,25,3,23,69,0.120,,
7,NA,280,2,2,2,13,10,23,3,23,69,0.120,,
7,NA,281,4,3,5,13,10,24,3,23,69,0.120,,
7,NA,282,2,2,2,13,10,26,3,23,69,0.120,,
7,NA,283,2,3,1,13,10,25,3,23,69,0.120,,
7,NA,284,5,5,5,13,10,24,3,23,69,0.120,,
7,NA,285,2,1,3,13,10,26,3,23,69,0.120,,
7,NA,286,3,3,3,13,10,26,3,23,69,0.120,,
7,NA,287,4,5,3,13,10,27,3,23,69,0.120,,
7,NA,288,3,1,5,13,10,24,3,23,69,0.120,,
7,NA,289,3.5,4,3,13,10,24,3,23,69,0.120,,
7,NA,290,2,3,1,13,10,25,3,23,69,0.120,,
7,NA,291,2,3,1,13,10,25,3,23,69,0.120,,
7,NA,292,2,3,1,13,10,24,3,23,69,0.120,,
7,NA,293,2,3,1,13,10,25,3,23,69,0.120,,
7,NA,294,3,4,2,13,10,24,3,23,69,0.120,,
7,NA,295,4,4,4,13,10,24,3,23,69,0.120,,
7,NA,296,1.5,1,2,13,10,26,3,23,69,0.120,,
7,NA,297,2,1,3,13,10,23,3,23,69,0.120,,
7,NA,298,3.5,4,3,18,16,35,2,34,68,0.118,,
7,NA,299,3.5,3,4,18,16,36,2,34,68,0.118,,
7,NA,300,2,2,2,18,16,36,2,34,68,0.118,,
7,NA,301,4.5,5,4,18,16,39,2,34,68,0.118,,
7,NA,302,3,2,4,9,4,13,5,13,65,0.113,,
7,NA,303,3.5,3,4,9,4,14,5,13,65,0.113,,
7,NA,304,3,3,3,9,4,16,5,13,65,0.113,,
7,NA,305,4,5,3,9,4,14,5,13,65,0.113,,
7,NA,306,1.5,1,2,17,15,34,2,32,64,0.111,,
7,NA,307,2.5,2,3,10,6,18,4,16,64,0.111,,
7,NA,308,3.5,3,4,10,6,19,4,16,64,0.111,,
7,NA,309,4.5,4,5,10,6,24,4,16,64,0.111,,
7,NA,310,2.5,3,2,17,15,34,2,32,64,0.111,,
7,NA,311,3,3,3,10,6,18,4,16,64,0.111,,
7,NA,312,2.5,3,2,17,15,36,2,32,64,0.111,,
7,NA,313,3.5,3,4,10,6,19,4,16,64,0.111,,
7,NA,314,4,4,4,10,6,18,4,16,64,0.111,,
7,NA,315,3,3,3,17,15,35,2,32,64,0.111,,
7,NA,316,4.5,4,5,10,6,18,4,16,64,0.111,,
7,NA,317,3,5,1,10,6,18,4,16,64,0.111,,
7,NA,318,2,1,3,17,15,36,2,32,64,0.111,,
7,NA,319,4,4,4,10,6,21,4,16,64,0.111,,
7,NA,320,5,5,5,10,6,18,4,16,64,0.111,,
7,NA,321,1,1,1,10,6,18,4,16,64,0.111,,
7,NA,322,4,4,4,12,9,23,3,21,63,0.109,,
7,NA,323,3.5,4,3,12,9,21,3,21,63,0.109,,
7,NA,324,2.5,3,2,12,9,21,3,21,63,0.109,,
7,NA,325,4.5,4,5,12,9,23,3,21,63,0.109,,
7,NA,326,4,4,4,12,9,24,3,21,63,0.109,,
7,NA,327,2.5,4,1,12,9,21,3,21,63,0.109,,
7,NA,328,2.5,3,2,12,9,21,3,21,63,0.109,,
7,NA,329,3.5,3,4,12,9,24,3,21,63,0.109,,
7,NA,330,3.5,2,5,12,9,23,3,21,63,0.109,,
7,NA,331,2,3,1,12,9,24,3,21,63,0.109,,
7,NA,332,3.5,2,5,12,9,22,3,21,63,0.109,,
7,NA,333,5,5,5,12,9,25,3,21,63,0.109,,
7,NA,334,2.5,3,2,12,9,21,3,21,63,0.109,,
7,NA,335,3,2,4,16,14,30,2,30,60,0.104,,
7,NA,336,3.5,4,3,16,14,32,2,30,60,0.104,,
7,NA,337,3,2,4,16,14,32,2,30,60,0.104,,
7,NA,338,2.5,2,3,16,14,32,2,30,60,0.104,,
7,NA,339,2,3,1,16,14,32,2,30,60,0.104,,
7,NA,340,3,4,2,16,14,33,2,30,60,0.104,,
7,NA,341,4,5,3,16,14,33,2,30,60,0.104,,
7,NA,342,3.5,3,4,11,8,21,3,19,57,0.099,,
7,NA,343,3,4,2,11,8,21,3,19,57,0.099,,
7,NA,344,2.5,3,2,11,8,21,3,19,57,0.099,,
7,NA,345,3,2,4,11,8,21,3,19,57,0.099,,
7,NA,346,3.5,5,2,11,8,21,3,19,57,0.099,,
7,NA,347,3,4,2,11,8,23,3,19,57,0.099,,
7,NA,348,3,4,2,11,8,20,3,19,57,0.099,,
7,NA,349,2.5,3,2,11,8,21,3,19,57,0.099,,
7,NA,350,2.5,2,3,11,8,20,3,19,57,0.099,,
7,NA,351,3,3,3,11,8,20,3,19,57,0.099,,
7,NA,352,3,3,3,11,8,21,3,19,57,0.099,,
7,NA,353,3,4,2,11,8,21,3,19,57,0.099,,
7,NA,354,2.5,3,2,11,8,19,3,19,57,0.099,,
7,NA,355,3,3,3,11,8,20,3,19,57,0.099,,
7,NA,356,2,3,1,11,8,20,3,19,57,0.099,,
7,NA,357,2,3,1,11,8,20,3,19,57,0.099,,
7,NA,358,3.5,4,3,11,8,22,3,19,57,0.099,,
7,NA,359,2.5,4,1,11,8,19,3,19,57,0.099,,
7,NA,360,2.5,3,2,11,8,20,3,19,57,0.099,,
7,NA,361,3,1,5,11,8,20,3,19,57,0.099,,
7,NA,362,4,5,3,11,8,19,3,19,57,0.099,,
7,NA,363,2,2,2,11,8,19,3,19,57,0.099,,
7,NA,364,4.5,4,5,11,8,19,3,19,57,0.099,,
7,NA,365,3.5,2,5,11,8,29,3,19,57,0.099,,
7,NA,366,3.5,4,3,11,8,20,3,19,57,0.099,,
7,NA,367,3.5,3,4,15,13,30,2,28,56,0.097,,
7,NA,368,3.5,4,3,9,5,18,4,14,56,0.097,,
7,NA,369,3.5,4,3,15,13,32,2,28,56,0.097,,
7,NA,370,1.5,1,2,15,13,38,2,28,56,0.097,,
7,NA,371,3,2,4,9,5,14,4,14,56,0.097,,
7,NA,372,2.5,2,3,9,5,15,4,14,56,0.097,,
7,NA,373,1,1,1,9,5,16,4,14,56,0.097,,
7,NA,374,2,3,1,9,5,15,4,14,56,0.097,,
7,NA,375,4.5,5,4,9,5,15,4,14,56,0.097,,
7,NA,376,3.5,5,2,15,13,30,2,28,56,0.097,,
7,NA,377,4,5,3,9,5,15,4,14,56,0.097,,
7,NA,378,4,4,4,9,5,17,4,14,56,0.097,,
7,NA,379,3,4,2,15,13,32,2,28,56,0.097,,
7,NA,380,4,3,5,15,13,29,2,28,56,0.097,,
7,NA,381,4,5,3,9,5,15,4,14,56,0.097,,
7,NA,382,2,1,3,15,13,29,2,28,56,0.097,,
7,NA,383,2.5,3,2,9,5,14,4,14,56,0.097,,
7,NA,384,2.5,4,1,9,5,14,4,14,56,0.097,,
7,NA,385,4.5,4,5,9,5,14,4,14,56,0.097,,
7,NA,386,2.5,1,4,15,13,30,2,28,56,0.097,,
7,NA,387,2.5,1,4,9,5,16,4,14,56,0.097,,
7,NA,388,2.5,2,3,15,13,29,2,28,56,0.097,,
7,NA,389,2.5,1,4,15,13,28,2,28,56,0.097,,
7,NA,390,2.5,3,2,9,5,17,4,14,56,0.097,,
7,NA,391,4,4,4,9,5,15,4,14,56,0.097,,
7,NA,392,2.5,2,3,9,5,17,4,14,56,0.097,,
7,NA,393,2,2,2,15,13,30,2,28,56,0.097,,
7,NA,394,1.5,2,1,15,13,29,2,28,56,0.097,,
7,NA,395,2.5,3,2,15,13,30,2,28,56,0.097,,
7,NA,396,3,4,2,15,13,29,2,28,56,0.097,,
7,NA,397,2.5,2,3,9,5,15,4,14,56,0.097,,
7,NA,398,1.5,2,1,9,5,16,4,14,56,0.097,,
7,NA,399,4,4,4,8,3,11,5,11,55,0.095,,
7,NA,400,4,4,4,8,3,11,5,11,55,0.095,,
7,NA,401,3.5,3,4,14,12,27,2,26,52,0.090,,
7,NA,402,2.5,3,2,14,12,27,2,26,52,0.090,,
7,NA,403,2.5,1,4,14,12,28,2,26,52,0.090,,
7,NA,404,3.5,4,3,14,12,27,2,26,52,0.090,,
7,NA,405,2.5,1,4,14,12,31,2,26,52,0.090,,
7,NA,406,4.5,5,4,14,12,30,2,26,52,0.090,,
7,NA,407,3,4,2,10,7,18,3,17,51,0.089,,
7,NA,408,3,2,4,10,7,17,3,17,51,0.089,,
7,NA,409,4.5,5,4,10,7,21,3,17,51,0.089,,
7,NA,410,3.5,3,4,10,7,18,3,17,51,0.089,,
7,NA,411,3,4,2,10,7,21,3,17,51,0.089,,
7,NA,412,2.5,3,2,10,7,18,3,17,51,0.089,,
7,NA,413,3,4,2,10,7,17,3,17,51,0.089,,
7,NA,414,3.5,4,3,10,7,22,3,17,51,0.089,,
7,NA,415,3.5,2,5,10,7,17,3,17,51,0.089,,
7,NA,416,3,3,3,10,7,18,3,17,51,0.089,,
7,NA,417,4,3,5,10,7,17,3,17,51,0.089,,
7,NA,418,3,4,2,10,7,17,3,17,51,0.089,,
7,NA,419,3,2,4,10,7,20,3,17,51,0.089,,
7,NA,420,1,1,1,10,7,19,3,17,51,0.089,,
7,NA,421,2.5,4,1,10,7,19,3,17,51,0.089,,
7,NA,422,3,4,2,10,7,17,3,17,51,0.089,,
7,NA,423,3,3,3,10,7,21,3,17,51,0.089,,
7,NA,424,2.5,3,2,10,7,17,3,17,51,0.089,,
7,NA,425,3,3,3,13,11,26,2,24,48,0.083,,
7,NA,426,2,1,3,13,11,27,2,24,48,0.083,,
7,NA,427,3,2,4,13,11,24,2,24,48,0.083,,
7,NA,428,2.5,3,2,8,4,13,4,12,48,0.083,,
7,NA,429,2.5,3,2,7,1,8,6,8,48,0.083,,
7,NA,430,1.5,2,1,13,11,26,2,24,48,0.083,,
7,NA,431,3,4,2,13,11,28,2,24,48,0.083,,
7,NA,432,2,2,2,13,11,27,2,24,48,0.083,,
7,NA,433,4,4,4,13,11,24,2,24,48,0.083,,
7,NA,434,4,4,4,13,11,27,2,24,48,0.083,,
7,NA,435,1.5,1,2,13,11,27,2,24,48,0.083,,
7,NA,436,2,2,2,8,4,13,4,12,48,0.083,,
7,NA,437,2.5,3,2,13,11,26,2,24,48,0.083,,
7,NA,438,3,3,3,13,11,26,2,24,48,0.083,,
7,NA,439,3.5,4,3,13,11,26,2,24,48,0.083,,
7,NA,440,3,2,4,13,11,25,2,24,48,0.083,,
7,NA,441,3.5,2,5,13,11,31,2,24,48,0.083,,
7,NA,442,2.5,2,3,13,11,25,2,24,48,0.083,,
7,NA,443,3.5,5,2,13,11,25,2,24,48,0.083,,
7,NA,444,2,2,2,13,11,26,2,24,48,0.083,,
7,NA,445,3,3,3,13,11,27,2,24,48,0.083,,
7,NA,446,5,5,5,13,11,25,2,24,48,0.083,,
7,NA,447,5,5,5,13,11,25,2,24,48,0.083,,
7,NA,448,4,4,4,8,4,16,4,12,48,0.083,,
7,NA,449,3.5,4,3,8,4,12,4,12,48,0.083,,
7,NA,450,2.5,3,2,13,11,26,2,24,48,0.083,,
7,NA,451,2,3,1,13,11,25,2,24,48,0.083,,
7,NA,452,3.5,3,4,13,11,25,2,24,48,0.083,,
7,NA,453,4,4,4,13,11,27,2,24,48,0.083,,
7,NA,454,2,1,3,13,11,26,2,24,48,0.083,,
7,NA,455,2.5,4,1,8,4,12,4,12,48,0.083,,
7,NA,456,3.5,3,4,8,4,13,4,12,48,0.083,,
7,NA,457,4,3,5,13,11,25,2,24,48,0.083,,
7,NA,458,2.5,3,2,13,11,24,2,24,48,0.083,,
7,NA,459,3,3,3,13,11,25,2,24,48,0.083,,
7,NA,460,5,5,5,8,4,14,4,12,48,0.083,,
7,NA,461,1.5,1,2,13,11,24,2,24,48,0.083,,
7,NA,462,3,4,2,8,4,17,4,12,48,0.083,,
7,NA,463,2.5,3,2,9,6,16,3,15,45,0.078,,
7,NA,464,1,1,1,23,22,47,1,45,45,0.078,,
7,NA,465,2.5,1,4,9,6,16,3,15,45,0.078,,
7,NA,466,3,4,2,23,22,45,1,45,45,0.078,,
7,NA,467,4,4,4,7,2,12,5,9,45,0.078,,
7,NA,468,3,2,4,9,6,20,3,15,45,0.078,,
7,NA,469,2.5,4,1,9,6,15,3,15,45,0.078,,
7,NA,470,4.5,5,4,9,6,18,3,15,45,0.078,,
7,NA,471,2,2,2,9,6,18,3,15,45,0.078,,
7,NA,472,2,2,2,9,6,16,3,15,45,0.078,,
7,NA,473,2.5,4,1,9,6,18,3,15,45,0.078,,
7,NA,474,4,3,5,9,6,15,3,15,45,0.078,,
7,NA,475,3,3,3,7,2,11,5,9,45,0.078,,
7,NA,476,3,2,4,9,6,17,3,15,45,0.078,,
7,NA,477,1.5,2,1,9,6,18,3,15,45,0.078,,
7,NA,478,3,3,3,9,6,19,3,15,45,0.078,,
7,NA,479,2.5,1,4,9,6,15,3,15,45,0.078,,
7,NA,480,2.5,2,3,9,6,18,3,15,45,0.078,,
7,NA,481,2.5,3,2,9,6,15,3,15,45,0.078,,
7,NA,482,4,3,5,9,6,17,3,15,45,0.078,,
7,NA,483,4,5,3,9,6,19,3,15,45,0.078,,
7,NA,484,3,5,1,9,6,19,3,15,45,0.078,,
7,NA,485,2.5,3,2,9,6,16,3,15,45,0.078,,
7,NA,486,4,5,3,7,2,11,5,9,45,0.078,,
7,NA,487,3,4,2,9,6,16,3,15,45,0.078,,
7,NA,488,3,4,2,9,6,17,3,15,45,0.078,,
7,NA,489,3.5,2,5,9,6,17,3,15,45,0.078,,
7,NA,490,2.5,4,1,9,6,17,3,15,45,0.078,,
7,NA,491,2,2,2,12,10,23,2,22,44,0.076,,
7,NA,492,2,1,3,12,10,24,2,22,44,0.076,,
7,NA,493,1.5,2,1,12,10,23,2,22,44,0.076,,
7,NA,494,1,1,1,12,10,24,2,22,44,0.076,,
7,NA,495,3.5,3,4,12,10,23,2,22,44,0.076,,
7,NA,496,3.5,4,3,12,10,23,2,22,44,0.076,,
7,NA,497,2.5,3,2,12,10,24,2,22,44,0.076,,
7,NA,498,3,4,2,12,10,24,2,22,44,0.076,,
7,NA,499,3.5,5,2,12,10,25,2,22,44,0.076,,
7,NA,500,1.5,2,1,12,10,23,2,22,44,0.076,,
7,NA,501,1.5,2,1,12,10,23,2,22,44,0.076,,
7,NA,502,2,2,2,12,10,24,2,22,44,0.076,,
7,NA,503,3,3,3,12,10,23,2,22,44,0.076,,
7,NA,504,1.5,2,1,12,10,25,2,22,44,0.076,,
7,NA,505,4,4,4,12,10,24,2,22,44,0.076,,
7,NA,506,2.5,3,2,12,10,24,2,22,44,0.076,,
7,NA,507,4.5,4,5,12,10,23,2,22,44,0.076,,
7,NA,508,3,3,3,12,10,25,2,22,44,0.076,,
7,NA,509,3,2,4,12,10,25,2,22,44,0.076,,
7,NA,510,3.5,4,3,12,10,23,2,22,44,0.076,,
7,NA,511,2.5,2,3,12,10,22,2,22,44,0.076,,
7,NA,512,3.5,2,5,12,10,24,2,22,44,0.076,,
7,NA,513,4.5,4,5,12,10,23,2,22,44,0.076,,
7,NA,514,3,2,4,22,21,45,1,43,43,0.075,,
7,NA,515,3.5,3,4,11,9,24,2,20,40,0.069,,
7,NA,516,2.5,4,1,11,9,21,2,20,40,0.069,,
7,NA,517,2.5,4,1,7,3,11,4,10,40,0.069,,
7,NA,518,3,2,4,11,9,21,2,20,40,0.069,,
7,NA,519,4,4,4,11,9,23,2,20,40,0.069,,
7,NA,520,3,4,2,11,9,23,2,20,40,0.069,,
7,NA,521,2.5,3,2,11,9,21,2,20,40,0.069,,
7,NA,522,4.5,4,5,11,9,23,2,20,40,0.069,,
7,NA,523,3.5,4,3,11,9,22,2,20,40,0.069,,
7,NA,524,1.5,2,1,11,9,21,2,20,40,0.069,,
7,NA,525,4,4,4,11,9,22,2,20,40,0.069,,
7,NA,526,2,2,2,11,9,21,2,20,40,0.069,,
7,NA,527,2,2,2,11,9,20,2,20,40,0.069,,
7,NA,528,3,2,4,11,9,22,2,20,40,0.069,,
7,NA,529,3.5,2,5,11,9,22,2,20,40,0.069,,
7,NA,530,2,3,1,11,9,22,2,20,40,0.069,,
7,NA,531,3,2,4,11,9,24,2,20,40,0.069,,
7,NA,532,3.5,2,5,11,9,23,2,20,40,0.069,,
7,NA,533,3.5,5,2,7,3,14,4,10,40,0.069,,
7,NA,534,2,2,2,11,9,20,2,20,40,0.069,,
7,NA,535,2.5,3,2,11,9,23,2,20,40,0.069,,
7,NA,536,1.5,2,1,11,9,22,2,20,40,0.069,,
7,NA,537,3,3,3,11,9,21,2,20,40,0.069,,
7,NA,538,2.5,3,2,11,9,22,2,20,40,0.069,,
7,NA,539,1.5,1,2,11,9,21,2,20,40,0.069,,
7,NA,540,3,3,3,11,9,25,2,20,40,0.069,,
7,NA,541,1,1,1,11,9,21,2,20,40,0.069,,
7,NA,542,1.5,2,1,11,9,20,2,20,40,0.069,,
7,NA,543,5,5,5,11,9,22,2,20,40,0.069,,
7,NA,544,1,1,1,11,9,21,2,20,40,0.069,,
7,NA,545,1,1,1,11,9,27,2,20,40,0.069,,
7,NA,546,2.5,3,2,7,3,10,4,10,40,0.069,,
7,NA,547,3.5,5,2,8,5,13,3,13,39,0.068,,
7,NA,548,3.5,3,4,8,5,13,3,13,39,0.068,,
7,NA,549,3,4,2,8,5,13,3,13,39,0.068,,
7,NA,550,1,1,1,8,5,14,3,13,39,0.068,,
7,NA,551,2.5,2,3,8,5,14,3,13,39,0.068,,
7,NA,552,5,5,5,8,5,15,3,13,39,0.068,,
7,NA,553,4.5,5,4,8,5,15,3,13,39,0.068,,
7,NA,554,2.5,3,2,8,5,13,3,13,39,0.068,,
7,NA,555,2.5,4,1,8,5,14,3,13,39,0.068,,
7,NA,556,3,4,2,8,5,16,3,13,39,0.068,,
7,NA,557,3,5,1,8,5,15,3,13,39,0.068,,
7,NA,558,2.5,2,3,8,5,14,3,13,39,0.068,,
7,NA,559,2,2,2,8,5,15,3,13,39,0.068,,
7,NA,560,2.5,3,2,8,5,14,3,13,39,0.068,,
7,NA,561,2.5,4,1,8,5,15,3,13,39,0.068,,
7,NA,562,3,2,4,8,5,15,3,13,39,0.068,,
7,NA,563,4,4,4,8,5,14,3,13,39,0.068,,
7,NA,564,2,3,1,8,5,14,3,13,39,0.068,,
7,NA,565,3.5,4,3,8,5,13,3,13,39,0.068,,
7,NA,566,2,3,1,8,5,17,3,13,39,0.068,,
7,NA,567,2,1,3,8,5,15,3,13,39,0.068,,
7,NA,568,3.5,4,3,8,5,15,3,13,39,0.068,,
7,NA,569,2,2,2,8,5,13,3,13,39,0.068,,
7,NA,570,3,5,1,8,5,14,3,13,39,0.068,,
7,NA,571,3,2,4,8,5,14,3,13,39,0.068,,
7,NA,572,2,2,2,8,5,14,3,13,39,0.068,,
7,NA,573,3,3,3,19,18,39,1,37,37,0.064,,
7,NA,574,3,5,1,19,18,39,1,37,37,0.064,,
7,NA,575,3,4,2,10,8,20,2,18,36,0.063,,
7,NA,576,2.5,3,2,10,8,18,2,18,36,0.063,,
7,NA,577,2.5,2,3,10,8,18,2,18,36,0.063,,
7,NA,578,4,5,3,10,8,22,2,18,36,0.063,,
7,NA,579,4,4,4,10,8,20,2,18,36,0.063,,
7,NA,580,2.5,2,3,10,8,18,2,18,36,0.063,,
7,NA,581,4,3,5,10,8,20,2,18,36,0.063,,
7,NA,582,3.5,3,4,10,8,19,2,18,36,0.063,,
7,NA,583,3,4,2,10,8,19,2,18,36,0.063,,
7,NA,584,3,3,3,10,8,18,2,18,36,0.063,,
7,NA,585,3,3,3,10,8,22,2,18,36,0.063,,
7,NA,586,3,4,2,10,8,20,2,18,36,0.063,,
7,NA,587,2.5,3,2,10,8,19,2,18,36,0.063,,
7,NA,588,2.5,3,2,10,8,20,2,18,36,0.063,,
7,NA,589,3,2,4,10,8,19,2,18,36,0.063,,
7,NA,590,2.5,3,2,10,8,19,2,18,36,0.063,,
7,NA,591,2,2,2,10,8,18,2,18,36,0.063,,
7,NA,592,3,1,5,10,8,24,2,18,36,0.063,,
7,NA,593,3.5,2,5,10,8,19,2,18,36,0.063,,
7,NA,594,3,3,3,10,8,19,2,18,36,0.063,,
7,NA,595,2,2,2,10,8,19,2,18,36,0.063,,
7,NA,596,3,3,3,10,8,23,2,18,36,0.063,,
7,NA,597,3.5,5,2,10,8,19,2,18,36,0.063,,
7,NA,598,2,2,2,10,8,20,2,18,36,0.063,,
7,NA,599,3,3,3,10,8,19,2,18,36,0.063,,
7,NA,600,3,2,4,10,8,19,2,18,36,0.063,,
7,NA,601,3,4,2,10,8,20,2,18,36,0.063,,
7,NA,602,3.5,5,2,10,8,20,2,18,36,0.063,,
7,NA,603,2,3,1,10,8,24,2,18,36,0.063,,
7,NA,604,2.5,2,3,10,8,20,2,18,36,0.063,,
7,NA,605,4,4,4,10,8,19,2,18,36,0.063,,
7,NA,606,3,3,3,10,8,19,2,18,36,0.063,,
7,NA,607,3,3,3,18,17,37,1,35,35,0.061,,
7,NA,608,2.5,2,3,18,17,37,1,35,35,0.061,,
7,NA,609,3,4,2,6,1,7,5,7,35,0.061,,
7,NA,610,4,4,4,18,17,38,1,35,35,0.061,,
7,NA,611,3.5,2,5,7,4,12,3,11,33,0.057,,
7,NA,612,2.5,1,4,7,4,13,3,11,33,0.057,,
7,NA,613,5,5,5,7,4,12,3,11,33,0.057,,
7,NA,614,4,4,4,7,4,13,3,11,33,0.057,,
7,NA,615,4,5,3,7,4,12,3,11,33,0.057,,
7,NA,616,2,3,1,7,4,12,3,11,33,0.057,,
7,NA,617,3,2,4,7,4,12,3,11,33,0.057,,
7,NA,618,1.5,2,1,7,4,11,3,11,33,0.057,,
7,NA,619,2.5,3,2,7,4,13,3,11,33,0.057,,
7,NA,620,3.5,3,4,7,4,14,3,11,33,0.057,,
7,NA,621,1.5,2,1,9,7,17,2,16,32,0.056,,
7,NA,622,2,2,2,9,7,18,2,16,32,0.056,,
7,NA,623,2,3,1,9,7,17,2,16,32,0.056,,
7,NA,624,3,1,5,9,7,18,2,16,32,0.056,,
7,NA,625,3.5,4,3,6,2,10,4,8,32,0.056,,
7,NA,626,2.5,2,3,9,7,19,2,16,32,0.056,,
7,NA,627,4,5,3,9,7,20,2,16,32,0.056,,
7,NA,628,3.5,4,3,9,7,16,2,16,32,0.056,,
7,NA,629,3.5,2,5,9,7,18,2,16,32,0.056,,
7,NA,630,3,4,2,9,7,20,2,16,32,0.056,,
7,NA,631,2.5,2,3,9,7,18,2,16,32,0.056,,
7,NA,632,3,3,3,9,7,17,2,16,32,0.056,,
7,NA,633,3,4,2,9,7,17,2,16,32,0.056,,
7,NA,634,2,1,3,9,7,19,2,16,32,0.056,,
7,NA,635,3,3,3,9,7,20,2,16,32,0.056,,
7,NA,636,3,3,3,9,7,16,2,16,32,0.056,,
7,NA,637,3,2,4,9,7,16,2,16,32,0.056,,
7,NA,638,3.5,4,3,9,7,17,2,16,32,0.056,,
7,NA,639,3,4,2,9,7,16,2,16,32,0.056,,
7,NA,640,3,2,4,9,7,18,2,16,32,0.056,,
7,NA,641,3.5,3,4,9,7,17,2,16,32,0.056,,
7,NA,642,5,5,5,9,7,16,2,16,32,0.056,,
7,NA,643,2.5,2,3,9,7,17,2,16,32,0.056,,
7,NA,644,3,2,4,9,7,17,2,16,32,0.056,,
7,NA,645,2.5,2,3,9,7,17,2,16,32,0.056,,
7,NA,646,4.5,4,5,9,7,18,2,16,32,0.056,,
7,NA,647,3,5,1,9,7,19,2,16,32,0.056,,
7,NA,648,3.5,4,3,9,7,19,2,16,32,0.056,,
7,NA,649,5,5,5,6,2,21,4,8,32,0.056,,
7,NA,650,2.5,2,3,9,7,16,2,16,32,0.056,,
7,NA,651,3.5,4,3,16,15,32,1,31,31,0.054,,
7,NA,652,4.5,4,5,16,15,32,1,31,31,0.054,,
7,NA,653,3.5,3,4,16,15,33,1,31,31,0.054,,
7,NA,654,3.5,4,3,16,15,35,1,31,31,0.054,,
7,NA,655,3.5,3,4,16,15,33,1,31,31,0.054,,
7,NA,656,3.5,3,4,15,14,30,1,29,29,0.050,,
7,NA,657,3,3,3,15,14,31,1,29,29,0.050,,
7,NA,658,2,2,2,15,14,29,1,29,29,0.050,,
7,NA,659,4.5,4,5,15,14,34,1,29,29,0.050,,
7,NA,660,2,2,2,15,14,30,1,29,29,0.050,,
7,NA,661,4,3,5,15,14,30,1,29,29,0.050,,
7,NA,662,3,3,3,15,14,29,1,29,29,0.050,,
7,NA,663,1.5,2,1,15,14,32,1,29,29,0.050,,
7,NA,664,1,1,1,15,14,31,1,29,29,0.050,,
7,NA,665,3.5,3,4,15,14,31,1,29,29,0.050,,
7,NA,666,2,3,1,15,14,48,1,29,29,0.050,,
7,NA,667,2,2,2,15,14,31,1,29,29,0.050,,
7,NA,668,2.5,3,2,15,14,30,1,29,29,0.050,,
7,NA,669,4,4,4,15,14,30,1,29,29,0.050,,
7,NA,670,3.5,4,3,15,14,30,1,29,29,0.050,,
7,NA,671,1,1,1,8,6,14,2,14,28,0.049,,
7,NA,672,3.5,3,4,8,6,16,2,14,28,0.049,,
7,NA,673,2.5,1,4,8,6,16,2,14,28,0.049,,
7,NA,674,3,4,2,8,6,15,2,14,28,0.049,,
7,NA,675,2,3,1,8,6,15,2,14,28,0.049,,
7,NA,676,3,4,2,8,6,15,2,14,28,0.049,,
7,NA,677,2.5,2,3,8,6,17,2,14,28,0.049,,
7,NA,678,3,4,2,8,6,14,2,14,28,0.049,,
7,NA,679,3.5,4,3,8,6,14,2,14,28,0.049,,
7,NA,680,2,2,2,8,6,15,2,14,28,0.049,,
7,NA,681,3.5,4,3,8,6,14,2,14,28,0.049,,
7,NA,682,2.5,2,3,8,6,15,2,14,28,0.049,,
7,NA,683,4,4,4,8,6,14,2,14,28,0.049,,
7,NA,684,1.5,1,2,8,6,16,2,14,28,0.049,,
7,NA,685,2,3,1,8,6,15,2,14,28,0.049,,
7,NA,686,2.5,3,2,8,6,16,2,14,28,0.049,,
7,NA,687,3,4,2,8,6,16,2,14,28,0.049,,
7,NA,688,3,5,1,8,6,17,2,14,28,0.049,,
7,NA,689,4,4,4,8,6,15,2,14,28,0.049,,
7,NA,690,3,2,4,8,6,14,2,14,28,0.049,,
7,NA,691,2.5,2,3,8,6,14,2,14,28,0.049,,
7,NA,692,2,3,1,8,6,16,2,14,28,0.049,,
7,NA,693,4,5,3,14,13,29,1,27,27,0.047,,
7,NA,694,2.5,2,3,6,3,12,3,9,27,0.047,,
7,NA,695,1,1,1,14,13,30,1,27,27,0.047,,
7,NA,696,3,4,2,14,13,29,1,27,27,0.047,,
7,NA,697,3,2,4,14,13,30,1,27,27,0.047,,
7,NA,698,1.5,2,1,14,13,30,1,27,27,0.047,,
7,NA,699,3,5,1,6,3,10,3,9,27,0.047,,
7,NA,700,1.5,1,2,14,13,29,1,27,27,0.047,,
7,NA,701,4,4,4,14,13,28,1,27,27,0.047,,
7,NA,702,3,4,2,14,13,30,1,27,27,0.047,,
7,NA,703,5,5,5,6,3,13,3,9,27,0.047,,
7,NA,704,2.5,1,4,14,13,32,1,27,27,0.047,,
7,NA,705,2.5,3,2,14,13,30,1,27,27,0.047,,
7,NA,706,2.5,2,3,14,13,28,1,27,27,0.047,,
7,NA,707,1.5,1,2,6,3,9,3,9,27,0.047,,
7,NA,708,2,1,3,14,13,31,1,27,27,0.047,,
7,NA,709,3,3,3,14,13,33,1,27,27,0.047,,
7,NA,710,4,4,4,14,13,30,1,27,27,0.047,,
7,NA,711,2,1,3,6,3,10,3,9,27,0.047,,
7,NA,712,4,3,5,14,13,33,1,27,27,0.047,,
7,NA,713,3,1,5,6,3,10,3,9,27,0.047,,
7,NA,714,3,5,1,6,3,16,3,9,27,0.047,,
7,NA,715,3,3,3,6,3,11,3,9,27,0.047,,
7,NA,716,2,1,3,13,12,27,1,25,25,0.043,,
7,NA,717,3,2,4,13,12,27,1,25,25,0.043,,
7,NA,718,3.5,4,3,13,12,25,1,25,25,0.043,,
7,NA,719,3,4,2,13,12,26,1,25,25,0.043,,
7,NA,720,4,4,4,13,12,27,1,25,25,0.043,,
7,NA,721,3,4,2,13,12,28,1,25,25,0.043,,
7,NA,722,3.5,3,4,13,12,27,1,25,25,0.043,,
7,NA,723,2.5,2,3,13,12,25,1,25,25,0.043,,
7,NA,724,4.5,4,5,13,12,27,1,25,25,0.043,,
7,NA,725,3,4,2,13,12,26,1,25,25,0.043,,
7,NA,726,3,3,3,13,12,26,1,25,25,0.043,,
7,NA,727,3,4,2,13,12,26,1,25,25,0.043,,
7,NA,728,1.5,2,1,13,12,28,1,25,25,0.043,,
7,NA,729,3,1,5,5,0,5,5,5,25,0.043,,
7,NA,730,2,2,2,13,12,26,1,25,25,0.043,,
7,NA,731,3,3,3,13,12,26,1,25,25,0.043,,
7,NA,732,2.5,2,3,13,12,29,1,25,25,0.043,,
7,NA,733,1,1,1,13,12,27,1,25,25,0.043,,
7,NA,734,3,3,3,13,12,26,1,25,25,0.043,,
7,NA,735,4,3,5,13,12,25,1,25,25,0.043,,
7,NA,736,2,1,3,13,12,30,1,25,25,0.043,,
7,NA,737,2,2,2,7,5,13,2,12,24,0.042,,
7,NA,738,3.5,5,2,7,5,13,2,12,24,0.042,,
7,NA,739,3.5,3,4,7,5,16,2,12,24,0.042,,
7,NA,740,4,4,4,7,5,13,2,12,24,0.042,,
7,NA,741,3.5,5,2,7,5,12,2,12,24,0.042,,
7,NA,742,3,2,4,7,5,12,2,12,24,0.042,,
7,NA,743,2,1,3,7,5,12,2,12,24,0.042,,
7,NA,744,2,2,2,7,5,15,2,12,24,0.042,,
7,NA,745,3.5,3,4,7,5,15,2,12,24,0.042,,
7,NA,746,3.5,3,4,7,5,13,2,12,24,0.042,,
7,NA,747,3.5,2,5,7,5,13,2,12,24,0.042,,
7,NA,748,1.5,2,1,5,1,7,4,6,24,0.042,,
7,NA,749,2,2,2,5,1,6,4,6,24,0.042,,
7,NA,750,3.5,3,4,7,5,14,2,12,24,0.042,,
7,NA,751,3.5,3,4,7,5,14,2,12,24,0.042,,
7,NA,752,4,4,4,7,5,13,2,12,24,0.042,,
7,NA,753,4,4,4,7,5,14,2,12,24,0.042,,
7,NA,754,2.5,4,1,7,5,14,2,12,24,0.042,,
7,NA,755,3.5,4,3,7,5,14,2,12,24,0.042,,
7,NA,756,2,3,1,7,5,14,2,12,24,0.042,,
7,NA,757,2.5,3,2,7,5,13,2,12,24,0.042,,
7,NA,758,2,2,2,12,11,48,1,23,23,0.040,,
7,NA,759,2,3,1,12,11,26,1,23,23,0.040,,
7,NA,760,3.5,3,4,12,11,25,1,23,23,0.040,,
7,NA,761,2.5,2,3,12,11,23,1,23,23,0.040,,
7,NA,762,2,2,2,12,11,24,1,23,23,0.040,,
7,NA,763,3.5,4,3,12,11,25,1,23,23,0.040,,
7,NA,764,2.5,3,2,12,11,23,1,23,23,0.040,,
7,NA,765,4.5,4,5,12,11,23,1,23,23,0.040,,
7,NA,766,3.5,4,3,12,11,26,1,23,23,0.040,,
7,NA,767,2,2,2,12,11,24,1,23,23,0.040,,
7,NA,768,3.5,3,4,12,11,24,1,23,23,0.040,,
7,NA,769,2,2,2,12,11,24,1,23,23,0.040,,
7,NA,770,2.5,3,2,12,11,24,1,23,23,0.040,,
7,NA,771,4.5,5,4,12,11,27,1,23,23,0.040,,
7,NA,772,3.5,3,4,12,11,25,1,23,23,0.040,,
7,NA,773,1.5,1,2,12,11,24,1,23,23,0.040,,
7,NA,774,4,4,4,12,11,26,1,23,23,0.040,,
7,NA,775,2.5,3,2,12,11,26,1,23,23,0.040,,
7,NA,776,3,4,2,12,11,25,1,23,23,0.040,,
7,NA,777,3.5,3,4,12,11,25,1,23,23,0.040,,
7,NA,778,1.5,2,1,12,11,24,1,23,23,0.040,,
7,NA,779,3.5,3,4,11,10,21,1,21,21,0.036,,
7,NA,780,2,2,2,11,10,22,1,21,21,0.036,,
7,NA,781,4.5,4,5,11,10,22,1,21,21,0.036,,
7,NA,782,1.5,1,2,11,10,22,1,21,21,0.036,,
7,NA,783,2.5,3,2,5,2,8,3,7,21,0.036,,
7,NA,784,3,4,2,11,10,21,1,21,21,0.036,,
7,NA,785,2.5,4,1,11,10,24,1,21,21,0.036,,
7,NA,786,2.5,1,4,11,10,22,1,21,21,0.036,,
7,NA,787,3.5,3,4,5,2,10,3,7,21,0.036,,
7,NA,788,2.5,4,1,11,10,23,1,21,21,0.036,,
7,NA,789,2.5,3,2,11,10,21,1,21,21,0.036,,
7,NA,790,2.5,1,4,11,10,23,1,21,21,0.036,,
7,NA,791,4,4,4,11,10,23,1,21,21,0.036,,
7,NA,792,3,4,2,11,10,23,1,21,21,0.036,,
7,NA,793,2,2,2,11,10,23,1,21,21,0.036,,
7,NA,794,4.5,5,4,5,2,8,3,7,21,0.036,,
7,NA,795,2,2,2,11,10,24,1,21,21,0.036,,
7,NA,796,3,5,1,11,10,21,1,21,21,0.036,,
7,NA,797,1,1,1,11,10,26,1,21,21,0.036,,
7,NA,798,4,4,4,11,10,23,1,21,21,0.036,,
7,NA,799,2.5,3,2,5,2,7,3,7,21,0.036,,
7,NA,800,3.5,3,4,11,10,21,1,21,21,0.036,,
7,NA,801,4,4,4,5,2,7,3,7,21,0.036,,
7,NA,802,3.5,2,5,11,10,22,1,21,21,0.036,,
7,NA,803,3.5,5,2,11,10,24,1,21,21,0.036,,
7,NA,804,3.5,2,5,11,10,22,1,21,21,0.036,,
7,NA,805,2,2,2,11,10,22,1,21,21,0.036,,
7,NA,806,3.5,4,3,6,4,10,2,10,20,0.035,,
7,NA,807,4.5,4,5,6,4,12,2,10,20,0.035,,
7,NA,808,4.5,5,4,6,4,10,2,10,20,0.035,,
7,NA,809,2,2,2,6,4,12,2,10,20,0.035,,
7,NA,810,4,4,4,6,4,10,2,10,20,0.035,,
7,NA,811,3.5,4,3,6,4,12,2,10,20,0.035,,
7,NA,812,4,4,4,6,4,12,2,10,20,0.035,,
7,NA,813,2,2,2,6,4,11,2,10,20,0.035,,
7,NA,814,3,4,2,6,4,12,2,10,20,0.035,,
7,NA,815,4,4,4,6,4,17,2,10,20,0.035,,
7,NA,816,2.5,3,2,6,4,11,2,10,20,0.035,,
7,NA,817,2.5,2,3,6,4,12,2,10,20,0.035,,
7,NA,818,2.5,4,1,6,4,14,2,10,20,0.035,,
7,NA,819,4,4,4,10,9,21,1,19,19,0.033,,
7,NA,820,4,4,4,10,9,23,1,19,19,0.033,,
7,NA,821,2.5,3,2,10,9,21,1,19,19,0.033,,
7,NA,822,3.5,5,2,10,9,20,1,19,19,0.033,,
7,NA,823,2,1,3,10,9,21,1,19,19,0.033,,
7,NA,824,4,4,4,10,9,20,1,19,19,0.033,,
7,NA,825,4,3,5,10,9,23,1,19,19,0.033,,
7,NA,826,1,1,1,10,9,21,1,19,19,0.033,,
7,NA,827,1.5,1,2,10,9,20,1,19,19,0.033,,
7,NA,828,2.5,4,1,10,9,21,1,19,19,0.033,,
7,NA,829,2,2,2,10,9,20,1,19,19,0.033,,
7,NA,830,2.5,2,3,10,9,19,1,19,19,0.033,,
7,NA,831,4,4,4,10,9,19,1,19,19,0.033,,
7,NA,832,4,4,4,10,9,20,1,19,19,0.033,,
7,NA,833,3,4,2,10,9,19,1,19,19,0.033,,
7,NA,834,3,2,4,10,9,22,1,19,19,0.033,,
7,NA,835,3,2,4,10,9,21,1,19,19,0.033,,
7,NA,836,3.5,2,5,10,9,20,1,19,19,0.033,,
7,NA,837,3,5,1,10,9,20,1,19,19,0.033,,
7,NA,838,3.5,3,4,10,9,20,1,19,19,0.033,,
7,NA,839,3.5,5,2,10,9,20,1,19,19,0.033,,
7,NA,840,2,2,2,10,9,19,1,19,19,0.033,,
7,NA,841,2,3,1,10,9,23,1,19,19,0.033,,
7,NA,842,1.5,2,1,10,9,22,1,19,19,0.033,,
7,NA,843,2.5,4,1,10,9,20,1,19,19,0.033,,
7,NA,844,4,4,4,10,9,20,1,19,19,0.033,,
7,NA,845,3,5,1,10,9,20,1,19,19,0.033,,
7,NA,846,3,4,2,10,9,19,1,19,19,0.033,,
7,NA,847,2.5,2,3,10,9,24,1,19,19,0.033,,
7,NA,848,1.5,2,1,10,9,19,1,19,19,0.033,,
7,NA,849,4,3,5,9,8,21,1,17,17,0.030,,
7,NA,850,2,2,2,9,8,18,1,17,17,0.030,,
7,NA,851,2.5,3,2,9,8,20,1,17,17,0.030,,
7,NA,852,3,2,4,9,8,19,1,17,17,0.030,,
7,NA,853,3,3,3,9,8,19,1,17,17,0.030,,
7,NA,854,4,5,3,9,8,18,1,17,17,0.030,,
7,NA,855,2.5,2,3,9,8,20,1,17,17,0.030,,
7,NA,856,2,1,3,9,8,19,1,17,17,0.030,,
7,NA,857,1.5,2,1,9,8,19,1,17,17,0.030,,
7,NA,858,3.5,2,5,9,8,17,1,17,17,0.030,,
7,NA,859,3.5,3,4,9,8,19,1,17,17,0.030,,
7,NA,860,4.5,4,5,9,8,17,1,17,17,0.030,,
7,NA,861,3,3,3,9,8,17,1,17,17,0.030,,
7,NA,862,3,2,4,9,8,17,1,17,17,0.030,,
7,NA,863,4.5,4,5,9,8,18,1,17,17,0.030,,
7,NA,864,4.5,4,5,9,8,19,1,17,17,0.030,,
7,NA,865,3,2,4,9,8,18,1,17,17,0.030,,
7,NA,866,3.5,3,4,9,8,20,1,17,17,0.030,,
7,NA,867,1.5,1,2,9,8,19,1,17,17,0.030,,
7,NA,868,2.5,3,2,9,8,19,1,17,17,0.030,,
7,NA,869,1,1,1,9,8,19,1,17,17,0.030,,
7,NA,870,1,1,1,9,8,17,1,17,17,0.030,,
7,NA,871,4.5,4,5,9,8,20,1,17,17,0.030,,
7,NA,872,2.5,2,3,9,8,18,1,17,17,0.030,,
7,NA,873,3.5,2,5,9,8,25,1,17,17,0.030,,
7,NA,874,3.5,4,3,9,8,18,1,17,17,0.030,,
7,NA,875,3.5,4,3,9,8,24,1,17,17,0.030,,
7,NA,876,2,3,1,9,8,17,1,17,17,0.030,,
7,NA,877,2.5,3,2,9,8,19,1,17,17,0.030,,
7,NA,878,3,2,4,9,8,18,1,17,17,0.030,,
7,NA,879,3.5,4,3,9,8,20,1,17,17,0.030,,
7,NA,880,2,2,2,9,8,18,1,17,17,0.030,,
7,NA,881,3,2,4,9,8,18,1,17,17,0.030,,
7,NA,882,4,4,4,9,8,21,1,17,17,0.030,,
7,NA,883,2.5,2,3,9,8,20,1,17,17,0.030,,
7,NA,884,4,3,5,9,8,19,1,17,17,0.030,,
7,NA,885,3,2,4,9,8,18,1,17,17,0.030,,
7,NA,886,2.5,4,1,9,8,20,1,17,17,0.030,,
7,NA,887,3,4,2,9,8,20,1,17,17,0.030,,
7,NA,888,2.5,3,2,9,8,18,1,17,17,0.030,,
7,NA,889,1,1,1,9,8,19,1,17,17,0.030,,
7,NA,890,2,2,2,9,8,18,1,17,17,0.030,,
7,NA,891,2,3,1,9,8,19,1,17,17,0.030,,
7,NA,892,4,3,5,9,8,18,1,17,17,0.030,,
7,NA,893,4,3,5,9,8,17,1,17,17,0.030,,
7,NA,894,3.5,2,5,9,8,19,1,17,17,0.030,,
7,NA,895,2.5,3,2,5,3,8,2,8,16,0.028,,
7,NA,896,1,1,1,5,3,8,2,8,16,0.028,,
7,NA,897,4,4,4,5,3,8,2,8,16,0.028,,
7,NA,898,4,4,4,5,3,12,2,8,16,0.028,,
7,NA,899,3.5,4,3,4,0,20,4,4,16,0.028,,
7,NA,900,3,3,3,5,3,9,2,8,16,0.028,,
7,NA,901,3,3,3,5,3,12,2,8,16,0.028,,
7,NA,902,2,2,2,5,3,16,2,8,16,0.028,,
7,NA,903,3,4,2,5,3,8,2,8,16,0.028,,
7,NA,904,3.5,2,5,5,3,11,2,8,16,0.028,,
7,NA,905,3,5,1,5,3,10,2,8,16,0.028,,
7,NA,906,3,3,3,5,3,10,2,8,16,0.028,,
7,NA,907,3,5,1,5,3,10,2,8,16,0.028,,
7,NA,908,2.5,1,4,5,3,14,2,8,16,0.028,,
7,NA,909,4.5,5,4,5,3,9,2,8,16,0.028,,
7,NA,910,3,5,1,5,3,9,2,8,16,0.028,,
7,NA,911,3,1,5,5,3,10,2,8,16,0.028,,
7,NA,912,2.5,3,2,8,7,15,1,15,15,0.026,,
7,NA,913,2.5,3,2,8,7,16,1,15,15,0.026,,
7,NA,914,4,4,4,8,7,17,1,15,15,0.026,,
7,NA,915,4,4,4,8,7,16,1,15,15,0.026,,
7,NA,916,4,4,4,8,7,17,1,15,15,0.026,,
7,NA,917,3,3,3,8,7,18,1,15,15,0.026,,
7,NA,918,3,3,3,8,7,16,1,15,15,0.026,,
7,NA,919,2,2,2,8,7,18,1,15,15,0.026,,
7,NA,920,4.5,4,5,4,1,7,3,5,15,0.026,,
7,NA,921,4,4,4,8,7,15,1,15,15,0.026,,
7,NA,922,4.5,5,4,8,7,16,1,15,15,0.026,,
7,NA,923,3,2,4,8,7,17,1,15,15,0.026,,
7,NA,924,2,1,3,8,7,16,1,15,15,0.026,,
7,NA,925,4,4,4,8,7,16,1,15,15,0.026,,
7,NA,926,1.5,2,1,8,7,17,1,15,15,0.026,,
7,NA,927,3,4,2,8,7,17,1,15,15,0.026,,
7,NA,928,1,1,1,8,7,17,1,15,15,0.026,,
7,NA,929,3.5,3,4,8,7,17,1,15,15,0.026,,
7,NA,930,2,3,1,8,7,15,1,15,15,0.026,,
7,NA,931,4,4,4,8,7,21,1,15,15,0.026,,
7,NA,932,3,2,4,8,7,17,1,15,15,0.026,,
7,NA,933,3.5,5,2,8,7,17,1,15,15,0.026,,
7,NA,934,2.5,3,2,8,7,16,1,15,15,0.026,,
7,NA,935,2,3,1,8,7,16,1,15,15,0.026,,
7,NA,936,3,3,3,8,7,17,1,15,15,0.026,,
7,NA,937,3,5,1,8,7,15,1,15,15,0.026,,
7,NA,938,3.5,4,3,8,7,17,1,15,15,0.026,,
7,NA,939,2.5,3,2,8,7,18,1,15,15,0.026,,
7,NA,940,2,1,3,4,1,6,3,5,15,0.026,,
7,NA,941,4.5,4,5,8,7,17,1,15,15,0.026,,
7,NA,942,3.5,4,3,7,6,14,1,13,13,0.023,,
7,NA,943,2.5,1,4,7,6,14,1,13,13,0.023,,
7,NA,944,3.5,2,5,7,6,21,1,13,13,0.023,,
7,NA,945,4,4,4,7,6,13,1,13,13,0.023,,
7,NA,946,2.5,2,3,7,6,21,1,13,13,0.023,,
7,NA,947,4,5,3,7,6,18,1,13,13,0.023,,
7,NA,948,2.5,1,4,7,6,17,1,13,13,0.023,,
7,NA,949,3.5,3,4,7,6,13,1,13,13,0.023,,
7,NA,950,3,4,2,7,6,16,1,13,13,0.023,,
7,NA,951,2,1,3,7,6,13,1,13,13,0.023,,
7,NA,952,3,4,2,7,6,13,1,13,13,0.023,,
7,NA,953,4,3,5,7,6,14,1,13,13,0.023,,
7,NA,954,2,3,1,7,6,14,1,13,13,0.023,,
7,NA,955,4,5,3,7,6,15,1,13,13,0.023,,
7,NA,956,2.5,3,2,7,6,15,1,13,13,0.023,,
7,NA,957,3.5,3,4,7,6,14,1,13,13,0.023,,
7,NA,958,3,2,4,7,6,14,1,13,13,0.023,,
7,NA,959,2.5,2,3,7,6,13,1,13,13,0.023,,
7,NA,960,2.5,3,2,7,6,20,1,13,13,0.023,,
7,NA,961,3,5,1,7,6,16,1,13,13,0.023,,
7,NA,962,4,4,4,7,6,14,1,13,13,0.023,,
7,NA,963,3,3,3,7,6,16,1,13,13,0.023,,
7,NA,964,2.5,3,2,7,6,18,1,13,13,0.023,,
7,NA,965,2,3,1,7,6,13,1,13,13,0.023,,
7,NA,966,4,3,5,7,6,14,1,13,13,0.023,,
7,NA,967,2.5,4,1,4,2,6,2,6,12,0.021,,
7,NA,968,3,4,2,4,2,6,2,6,12,0.021,,
7,NA,969,3.5,5,2,4,2,15,2,6,12,0.021,,
7,NA,970,2,2,2,4,2,8,2,6,12,0.021,,
7,NA,971,4.5,4,5,4,2,6,2,6,12,0.021,,
7,NA,972,1.5,1,2,6,5,11,1,11,11,0.019,,
7,NA,973,2.5,3,2,6,5,12,1,11,11,0.019,,
7,NA,974,3,3,3,6,5,11,1,11,11,0.019,,
7,NA,975,3,1,5,6,5,12,1,11,11,0.019,,
7,NA,976,2,2,2,6,5,13,1,11,11,0.019,,
7,NA,977,3,3,3,6,5,11,1,11,11,0.019,,
7,NA,978,3.5,3,4,6,5,14,1,11,11,0.019,,
7,NA,979,3.5,2,5,6,5,12,1,11,11,0.019,,
7,NA,980,2.5,3,2,6,5,14,1,11,11,0.019,,
7,NA,981,4,4,4,6,5,11,1,11,11,0.019,,
7,NA,982,2.5,4,1,6,5,12,1,11,11,0.019,,
7,NA,983,4,4,4,6,5,11,1,11,11,0.019,,
7,NA,984,2,2,2,6,5,11,1,11,11,0.019,,
7,NA,985,3,2,4,6,5,11,1,11,11,0.019,,
7,NA,986,4,5,3,6,5,15,1,11,11,0.019,,
7,NA,987,2,3,1,6,5,14,1,11,11,0.019,,
7,NA,988,3.5,5,2,6,5,12,1,11,11,0.019,,
7,NA,989,2,2,2,6,5,12,1,11,11,0.019,,
7,NA,990,4.5,5,4,6,5,14,1,11,11,0.019,,
7,NA,991,3.5,3,4,6,5,13,1,11,11,0.019,,
7,NA,992,2.5,3,2,6,5,12,1,11,11,0.019,,
7,NA,993,2.5,2,3,6,5,16,1,11,11,0.019,,
7,NA,994,2,1,3,5,4,10,1,9,9,0.016,,
7,NA,995,2.5,2,3,5,4,9,1,9,9,0.016,,
7,NA,996,3,3,3,5,4,9,1,9,9,0.016,,
7,NA,997,3,2,4,5,4,9,1,9,9,0.016,,
7,NA,998,3,3,3,5,4,11,1,9,9,0.016,,
7,NA,999,2,2,2,5,4,9,1,9,9,0.016,,
7,NA,1000,4,4,4,5,4,10,1,9,9,0.016,,
7,NA,1001,4,4,4,5,4,11,1,9,9,0.016,,
7,NA,1002,4,4,4,5,4,11,1,9,9,0.016,,
7,NA,1003,4.5,4,5,5,4,9,1,9,9,0.016,,
7,NA,1004,2.5,2,3,5,4,10,1,9,9,0.016,,
7,NA,1005,2.5,1,4,5,4,10,1,9,9,0.016,,
7,NA,1006,2,3,1,5,4,9,1,9,9,0.016,,
7,NA,1007,3.5,5,2,5,4,10,1,9,9,0.016,,
7,NA,1008,2.5,3,2,5,4,10,1,9,9,0.016,,
7,NA,1009,4,4,4,5,4,10,1,9,9,0.016,,
7,NA,1010,3,1,5,5,4,10,1,9,9,0.016,,
7,NA,1011,2.5,2,3,5,4,10,1,9,9,0.016,,
7,NA,1012,3.5,5,2,5,4,16,1,9,9,0.016,,
7,NA,1013,3.5,3,4,5,4,10,1,9,9,0.016,,
7,NA,1014,3,5,1,5,4,11,1,9,9,0.016,,
7,NA,1015,2.5,3,2,5,4,13,1,9,9,0.016,,
7,NA,1016,2,1,3,3,1,7,2,4,8,0.014,,
7,NA,1017,3,2,4,3,1,21,2,4,8,0.014,,
7,NA,1018,3,4,2,3,1,6,2,4,8,0.014,,
7,NA,1019,3,2,4,3,1,5,2,4,8,0.014,,
7,NA,1020,2.5,2,3,3,1,5,2,4,8,0.014,,
7,NA,1021,3,2,4,4,3,7,1,7,7,0.012,,
7,NA,1022,3,5,1,4,3,8,1,7,7,0.012,,
7,NA,1023,2.5,1,4,4,3,19,1,7,7,0.012,,
7,NA,1024,5,5,5,4,3,7,1,7,7,0.012,,
7,NA,1025,2.5,4,1,4,3,8,1,7,7,0.012,,
7,NA,1026,3,2,4,3,2,6,1,5,5,0.009,,
7,NA,1027,4.5,4,5,3,2,7,1,5,5,0.009,,
7,NA,1028,3.5,3,4,3,2,5,1,5,5,0.009,,
7,NA,1029,3,4,2,3,2,9,1,5,5,0.009,,
7,NA,1030,1,1,1,3,2,6,1,5,5,0.009,,
7,NA,1031,3,4,2,2,0,11,2,2,4,0.007,,
7,NA,1032,2,3,1,2,0,3,2,2,4,0.007,,
7,NA,1033,2.5,3,2,2,0,6,2,2,4,0.007,,
7,NA,1034,2.5,1,4,2,1,3,1,3,3,0.005,,
7,NA,1035,2.5,2,3,2,1,3,1,3,3,0.005,,
7,NA,1036,3,4,2,2,1,6,1,3,3,0.005,,
7,NA,1037,3,2,4,2,1,3,1,3,3,0.005,,
7,NA,1038,2.5,3,2,2,1,4,1,3,3,0.005,,
7,NA,1039,2,2,2,1,0,12,1,1,1,0.002,,
7,NA,1040,1,1,1,1,0,1,1,1,1,0.002,,
7,NA,1041,2.5,2,3,1,0,25,1,1,1,0.002,,
7,NA,1042,2.5,2,3,1,0,1,1,1,1,0.002,,
7,NA,1043,3,2,4,1,0,27,1,1,1,0.002,,
7,NA,1044,4,5,3,1,0,30,1,1,1,0.002,,
7,NA,1045,2,2,2,1,0,22,1,1,1,0.002,,
7,NA,1046,4,4,4,1,0,15,1,1,1,0.002,,
7,NA,1047,2.5,3,2,1,0,29,1,1,1,0.002,,
7,NA,1048,3.5,3,4,1,0,18,1,1,1,0.002,,
7,NA,1049,3.5,5,2,1,0,25,1,1,1,0.002,,
7,NA,1050,2.5,2,3,0,0,18,0,0,0,0.000,,
7,NA,1051,3,3,3,0,0,0,0,0,0,0.000,,
7,NA,1052,3,5,1,0,0,21,0,0,0,0.000,,
7,NA,1053,2.5,3,2,7,7,15,0,14,0,0.000,,
7,NA,1054,4,4,4,12,12,27,0,24,0,0.000,,
7,NA,1055,1.5,2,1,10,10,23,0,20,0,0.000,,
7,NA,1056,2,2,2,7,7,14,0,14,0,0.000,,
7,NA,1057,3,2,4,16,16,35,0,32,0,0.000,,
7,NA,1058,4,4,4,11,11,24,0,22,0,0.000,,
7,NA,1059,3,2,4,10,10,20,0,20,0,0.000,,
7,NA,1060,3,2,4,10,10,22,0,20,0,0.000,,
7,NA,1061,2,3,1,14,14,30,0,28,0,0.000,,
7,NA,1062,3,3,3,0,0,0,0,0,0,0.000,,
7,NA,1063,3,3,3,0,0,0,0,0,0,0.000,,
7,NA,1064,4,3,5,0,0,24,0,0,0,0.000,,
7,NA,1065,3.5,2,5,7,7,16,0,14,0,0.000,,
7,NA,1066,3.5,4,3,7,7,17,0,14,0,0.000,,
7,NA,1067,2.5,2,3,9,9,19,0,18,0,0.000,,
7,NA,1068,3,2,4,0,0,28,0,0,0,0.000,,
7,NA,1069,4,5,3,0,0,27,0,0,0,0.000,,
7,NA,1070,2,2,2,5,5,10,0,10,0,0.000,,
7,NA,1071,3,5,1,4,4,9,0,8,0,0.000,,
7,NA,1072,2,3,1,0,0,23,0,0,0,0.000,,
7,NA,1073,4.5,5,4,5,5,12,0,10,0,0.000,,
7,NA,1074,3,4,2,4,4,8,0,8,0,0.000,,
7,NA,1075,2.5,3,2,10,10,21,0,20,0,0.000,,
7,NA,1076,4,4,4,6,6,12,0,12,0,0.000,,
7,NA,1077,2,2,2,0,0,0,0,0,0,0.000,,
7,NA,1078,3,5,1,0,0,0,0,0,0,0.000,,
7,NA,1079,4,4,4,0,0,0,0,0,0,0.000,,
7,NA,1080,4.5,4,5,11,11,22,0,22,0,0.000,,
7,NA,1081,2,2,2,9,9,19,0,18,0,0.000,,
7,NA,1082,3,2,4,9,9,22,0,18,0,0.000,,
7,NA,1083,3.5,5,2,0,0,21,0,0,0,0.000,,
7,NA,1084,3.5,4,3,5,5,12,0,10,0,0.000,,
7,NA,1085,4.5,5,4,0,0,0,0,0,0,0.000,,
7,NA,1086,2,1,3,8,8,17,0,16,0,0.000,,
7,NA,1087,2.5,1,4,0,0,12,0,0,0,0.000,,
7,NA,1088,3.5,3,4,0,0,19,0,0,0,0.000,,
7,NA,1089,2.5,3,2,8,8,19,0,16,0,0.000,,
7,NA,1090,3,3,3,9,9,19,0,18,0,0.000,,
7,NA,1091,2.5,2,3,5,5,11,0,10,0,0.000,,
7,NA,1092,5,5,5,3,3,8,0,6,0,0.000,,
7,NA,1093,2.5,4,1,14,14,29,0,28,0,0.000,,
7,NA,1094,2.5,3,2,0,0,23,0,0,0,0.000,,
7,NA,1095,5,5,5,5,5,10,0,10,0,0.000,,
7,NA,1096,3.5,4,3,0,0,0,0,0,0,0.000,,
7,NA,1097,3,2,4,7,7,14,0,14,0,0.000,,
7,NA,1098,2,2,2,8,8,19,0,16,0,0.000,,
7,NA,1099,3,3,3,8,8,17,0,16,0,0.000,,
7,NA,1100,2.5,2,3,14,14,33,0,28,0,0.000,,
7,NA,1101,2,2,2,7,7,17,0,14,0,0.000,,
7,NA,1102,3.5,2,5,12,12,26,0,24,0,0.000,,
7,NA,1103,4,5,3,5,5,12,0,10,0,0.000,,
7,NA,1104,3.5,5,2,7,7,15,0,14,0,0.000,,
7,NA,1105,3.5,4,3,0,0,0,0,0,0,0.000,,
7,NA,1106,2,2,2,8,8,19,0,16,0,0.000,,
7,NA,1107,3.5,4,3,2,2,5,0,4,0,0.000,,
7,NA,1108,2.5,2,3,10,10,22,0,20,0,0.000,,
7,NA,1109,3,4,2,14,14,30,0,28,0,0.000,,
7,NA,1110,2.5,2,3,10,10,21,0,20,0,0.000,,
7,NA,1111,4.5,4,5,10,10,21,0,20,0,0.000,,
7,NA,1112,3,3,3,0,0,0,0,0,0,0.000,,
7,NA,1113,1,1,1,3,3,6,0,6,0,0.000,,
7,NA,1114,3.5,3,4,8,8,18,0,16,0,0.000,,
7,NA,1115,3,4,2,8,8,19,0,16,0,0.000,,
7,NA,1116,2,1,3,7,7,14,0,14,0,0.000,,
7,NA,1117,2.5,3,2,16,16,38,0,32,0,0.000,,
7,NA,1118,3.5,3,4,8,8,19,0,16,0,0.000,,
7,NA,1119,3.5,4,3,9,9,20,0,18,0,0.000,,
7,NA,1120,3,4,2,14,14,32,0,28,0,0.000,,
7,NA,1121,4.5,4,5,8,8,19,0,16,0,0.000,,
7,NA,1122,3.5,4,3,12,12,25,0,24,0,0.000,,
7,NA,1123,2,2,2,11,11,26,0,22,0,0.000,,
7,NA,1124,3,5,1,11,11,22,0,22,0,0.000,,
7,NA,1125,3,4,2,8,8,16,0,16,0,0.000,,
7,NA,1126,3.5,4,3,12,12,24,0,24,0,0.000,,
7,NA,1127,3.5,2,5,12,12,27,0,24,0,0.000,,
7,NA,1128,3,4,2,0,0,0,0,0,0,0.000,,
7,NA,1129,3,2,4,10,10,21,0,20,0,0.000,,
7,NA,1130,2.5,2,3,6,6,13,0,12,0,0.000,,
7,NA,1131,3.5,2,5,9,9,24,0,18,0,0.000,,
7,NA,1132,1.5,2,1,19,19,42,0,38,0,0.000,,
7,NA,1133,2.5,3,2,0,0,24,0,0,0,0.000,,
7,NA,1134,2,2,2,10,10,20,0,20,0,0.000,,
7,NA,1135,3,5,1,0,0,0,0,0,0,0.000,,
7,NA,1136,3,2,4,13,13,26,0,26,0,0.000,,
7,NA,1137,3,2,4,10,10,22,0,20,0,0.000,,
7,NA,1138,1,1,1,11,11,22,0,22,0,0.000,,
7,NA,1139,3.5,3,4,13,13,27,0,26,0,0.000,,
7,NA,1140,3,4,2,0,0,0,0,0,0,0.000,,
7,NA,1141,3.5,3,4,11,11,23,0,22,0,0.000,,
7,NA,1142,2,2,2,4,4,11,0,8,0,0.000,,
7,NA,1143,1.5,1,2,3,3,7,0,6,0,0.000,,
7,NA,1144,3,2,4,10,10,20,0,20,0,0.000,,
7,NA,1145,3,4,2,0,0,19,0,0,0,0.000,,
7,NA,1146,4,4,4,9,9,19,0,18,0,0.000,,
7,NA,1147,4,3,5,10,10,21,0,20,0,0.000,,
7,NA,1148,2.5,2,3,9,9,21,0,18,0,0.000,,
7,NA,1149,4.5,5,4,6,6,12,0,12,0,0.000,,
7,NA,1150,2,3,1,0,0,20,0,0,0,0.000,,
7,NA,1151,4.5,4,5,7,7,16,0,14,0,0.000,,
7,NA,1152,3.5,4,3,0,0,9,0,0,0,0.000,,
7,NA,1153,4,5,3,4,4,8,0,8,0,0.000,,
7,NA,1154,3,2,4,0,0,0,0,0,0,0.000,,
7,NA,1155,4.5,5,4,4,4,8,0,8,0,0.000,,
7,NA,1156,2,2,2,11,11,23,0,22,0,0.000,,
7,NA,1157,3.5,3,4,0,0,19,0,0,0,0.000,,
7,NA,1158,2,2,2,10,10,22,0,20,0,0.000,,
7,NA,1159,3,5,1,15,15,32,0,30,0,0.000,,
7,NA,1160,3,4,2,6,6,14,0,12,0,0.000,,
7,NA,1161,3.5,5,2,8,8,18,0,16,0,0.000,,
7,NA,1162,4,4,4,12,12,26,0,24,0,0.000,,
7,NA,1163,3.5,2,5,10,10,22,0,20,0,0.000,,
7,NA,1164,2.5,2,3,9,9,19,0,18,0,0.000,,
7,NA,1165,4.5,5,4,9,9,19,0,18,0,0.000,,
7,NA,1166,4,4,4,8,8,16,0,16,0,0.000,,
7,NA,1167,3.5,3,4,3,3,7,0,6,0,0.000,,
7,NA,1168,3,2,4,6,6,13,0,12,0,0.000,,
7,NA,1169,4,4,4,10,10,21,0,20,0,0.000,,
7,NA,1170,3.5,4,3,7,7,15,0,14,0,0.000,,
7,NA,1171,5,5,5,0,0,6,0,0,0,0.000,,
7,NA,1172,3.5,4,3,10,10,21,0,20,0,0.000,,
7,NA,1173,2.5,4,1,13,13,27,0,26,0,0.000,,
7,NA,1174,1.5,1,2,7,7,14,0,14,0,0.000,,
7,NA,1175,1.5,2,1,8,8,19,0,16,0,0.000,,
7,NA,1176,2.5,3,2,15,15,32,0,30,0,0.000,,
7,NA,1177,4,3,5,6,6,14,0,12,0,0.000,,
7,NA,1178,2,3,1,12,12,25,0,24,0,0.000,,
7,NA,1179,3,4,2,6,6,13,0,12,0,0.000,,
7,NA,1180,3,2,4,0,0,19,0,0,0,0.000,,
7,NA,1181,2,3,1,11,11,23,0,22,0,0.000,,
7,NA,1182,5,5,5,23,23,48,0,46,0,0.000,,
7,NA,1183,1.5,2,1,8,8,17,0,16,0,0.000,,
7,NA,1184,4.5,4,5,0,0,14,0,0,0,0.000,,
7,NA,1185,2.5,2,3,0,0,18,0,0,0,0.000,,
7,NA,1186,3,4,2,5,5,14,0,10,0,0.000,,
7,NA,1187,1,1,1,12,12,26,0,24,0,0.000,,
7,NA,1188,1.5,1,2,5,5,16,0,10,0,0.000,,
7,NA,1189,1,1,1,12,12,26,0,24,0,0.000,,
7,NA,1190,2.5,3,2,0,0,0,0,0,0,0.000,,
7,NA,1191,2,3,1,0,0,22,0,0,0,0.000,,
7,NA,1192,3.5,3,4,14,14,30,0,28,0,0.000,,
7,NA,1193,3,2,4,12,12,24,0,24,0,0.000,,
7,NA,1194,3.5,5,2,0,0,20,0,0,0,0.000,,
7,NA,1195,3,5,1,10,10,20,0,20,0,0.000,,
7,NA,1196,2,2,2,17,17,35,0,34,0,0.000,,
7,NA,1197,2.5,1,4,2,2,6,0,4,0,0.000,,
7,NA,1198,3.5,3,4,0,0,0,0,0,0,0.000,,
7,NA,1199,2.5,2,3,3,3,6,0,6,0,0.000,,
7,NA,1200,2.5,1,4,11,11,23,0,22,0,0.000,,
7,NA,1201,3.5,3,4,12,12,25,0,24,0,0.000,,
7,NA,1202,2.5,4,1,14,14,28,0,28,0,0.000,,
7,NA,1203,2.5,2,3,16,16,36,0,32,0,0.000,,
7,NA,1204,1.5,2,1,7,7,16,0,14,0,0.000,,
7,NA,1205,4,4,4,3,3,6,0,6,0,0.000,,
7,NA,1206,3,2,4,11,11,24,0,22,0,0.000,,
7,NA,1207,2,1,3,8,8,16,0,16,0,0.000,,
7,NA,1208,4,4,4,7,7,14,0,14,0,0.000,,
7,NA,1209,2.5,3,2,0,0,10,0,0,0,0.000,,
7,NA,1210,3,3,3,5,5,12,0,10,0,0.000,,
7,NA,1211,2,2,2,8,8,17,0,16,0,0.000,,
7,NA,1212,2,3,1,11,11,23,0,22,0,0.000,,
7,NA,1213,2.5,4,1,0,0,16,0,0,0,0.000,,
7,NA,1214,4,5,3,13,13,28,0,26,0,0.000,,
7,NA,1215,2.5,2,3,6,6,15,0,12,0,0.000,,
7,NA,1216,2,2,2,12,12,25,0,24,0,0.000,,
7,NA,1217,2.5,3,2,0,0,18,0,0,0,0.000,,
7,NA,1218,2,2,2,1,1,19,0,2,0,0.000,,
7,NA,1219,2,2,2,0,0,19,0,0,0,0.000,,
7,NA,1220,3,3,3,0,0,0,0,0,0,0.000,,
7,NA,1221,2.5,4,1,5,5,10,0,10,0,0.000,,
7,NA,1222,2.5,3,2,13,13,29,0,26,0,0.000,,
7,NA,1223,2.5,3,2,10,10,20,0,20,0,0.000,,
7,NA,1224,3.5,4,3,13,13,27,0,26,0,0.000,,
7,NA,1225,3,2,4,0,0,0,0,0,0,0.000,,
7,NA,1226,3.5,4,3,16,16,35,0,32,0,0.000,,
7,NA,1227,3.5,4,3,7,7,17,0,14,0,0.000,,
7,NA,1228,3,2,4,18,18,37,0,36,0,0.000,,
7,NA,1229,3,3,3,11,11,27,0,22,0,0.000,,
7,NA,1230,2.5,1,4,16,16,34,0,32,0,0.000,,
7,NA,1231,2.5,2,3,0,0,0,0,0,0,0.000,,
7,NA,1232,2.5,2,3,9,9,18,0,18,0,0.000,,
7,NA,1233,2,2,2,9,9,23,0,18,0,0.000,,
7,NA,1234,2,3,1,6,6,16,0,12,0,0.000,,
7,NA,1235,3,3,3,10,10,22,0,20,0,0.000,,
7,NA,1236,3.5,4,3,7,7,16,0,14,0,0.000,,
7,NA,1237,3,5,1,22,22,46,0,44,0,0.000,,
7,NA,1238,2.5,2,3,0,0,0,0,0,0,0.000,,
7,NA,1239,1.5,2,1,13,13,32,0,26,0,0.000,,
7,NA,1240,3,1,5,6,6,19,0,12,0,0.000,,
7,NA,1241,3,3,3,2,2,5,0,4,0,0.000,,
7,NA,1242,5,5,5,9,9,19,0,18,0,0.000,,
7,NA,1243,3,3,3,6,6,15,0,12,0,0.000,,
7,NA,1244,4,3,5,7,7,18,0,14,0,0.000,,
7,NA,1245,2.5,1,4,0,0,0,0,0,0,0.000,,
7,NA,1246,4,5,3,0,0,18,0,0,0,0.000,,
7,NA,1247,3,1,5,0,0,31,0,0,0,0.000,,
7,NA,1248,2.5,4,1,0,0,22,0,0,0,0.000,,
7,NA,1249,3.5,4,3,5,5,12,0,10,0,0.000,,
7,NA,1250,2.5,1,4,10,10,25,0,20,0,0.000,,
7,NA,1251,3.5,3,4,0,0,0,0,0,0,0.000,,
7,NA,1252,3,4,2,9,9,20,0,18,0,0.000,,
7,NA,1253,1.5,1,2,16,16,34,0,32,0,0.000,,
7,NA,1254,4,4,4,10,10,21,0,20,0,0.000,,
7,NA,1255,3,1,5,6,6,12,0,12,0,0.000,,
7,NA,1256,2,1,3,0,0,0,0,0,0,0.000,,
7,NA,1257,3,2,4,0,0,1,0,0,0,0.000,,
7,NA,1258,2,2,2,0,0,47,0,0,0,0.000,,
7,NA,1259,2.5,3,2,14,14,29,0,28,0,0.000,,
7,NA,1260,4.5,5,4,14,14,30,0,28,0,0.000,,
7,NA,1261,1.5,1,2,10,10,24,0,20,0,0.000,,
7,NA,1262,1,1,1,8,8,18,0,16,0,0.000,,
7,NA,1263,2,2,2,11,11,26,0,22,0,0.000,,
7,NA,1264,2.5,4,1,12,12,24,0,24,0,0.000,,
7,NA,1265,3,4,2,6,6,12,0,12,0,0.000,,
7,NA,1266,2,3,1,4,4,8,0,8,0,0.000,,
7,NA,1267,2.5,2,3,12,12,28,0,24,0,0.000,,
7,NA,1268,2.5,2,3,13,13,30,0,26,0,0.000,,
7,NA,1269,3,2,4,1,1,17,0,2,0,0.000,,
7,NA,1270,2.5,3,2,22,22,48,0,44,0,0.000,,
7,NA,1271,2.5,2,3,0,0,0,0,0,0,0.000,,
7,NA,1272,2.5,2,3,6,6,14,0,12,0,0.000,,
7,NA,1273,2.5,2,3,11,11,23,0,22,0,0.000,,
7,NA,1274,3,5,1,9,9,18,0,18,0,0.000,,
7,NA,1275,2,2,2,6,6,12,0,12,0,0.000,,
7,NA,1276,4.5,5,4,0,0,1,0,0,0,0.000,,
7,NA,1277,3.5,4,3,6,6,13,0,12,0,0.000,,
7,NA,1278,2.5,3,2,9,9,18,0,18,0,0.000,,
7,NA,1279,2,3,1,11,11,23,0,22,0,0.000,,
7,NA,1280,3.5,5,2,10,10,20,0,20,0,0.000,,
7,NA,1281,1.5,2,1,0,0,29,0,0,0,0.000,,
7,NA,1282,3,2,4,7,7,17,0,14,0,0.000,,
7,NA,1283,2,2,2,8,8,18,0,16,0,0.000,,
7,NA,1284,4,3,5,6,6,16,0,12,0,0.000,,
7,NA,1285,2.5,4,1,6,6,14,0,12,0,0.000,,
7,NA,1286,3.5,2,5,7,7,17,0,14,0,0.000,,
7,NA,1287,3,3,3,8,8,18,0,16,0,0.000,,
7,NA,1288,2,2,2,11,11,24,0,22,0,0.000,,
7,NA,1289,3,3,3,11,11,24,0,22,0,0.000,,
7,NA,1290,2.5,2,3,0,0,11,0,0,0,0.000,,
7,NA,1291,3,5,1,5,5,11,0,10,0,0.000,,
7,NA,1292,4,4,4,7,7,19,0,14,0,0.000,,
7,NA,1293,1,1,1,7,7,16,0,14,0,0.000,,
7,NA,1294,2,3,1,6,6,13,0,12,0,0.000,,
7,NA,1295,4,4,4,7,7,15,0,14,0,0.000,,
7,NA,1296,3,5,1,6,6,14,0,12,0,0.000,,
7,NA,1297,2,1,3,4,4,10,0,8,0,0.000,,
7,NA,1298,4,4,4,7,7,15,0,14,0,0.000,,
7,NA,1299,2.5,3,2,5,5,15,0,10,0,0.000,,
7,NA,1300,2.5,4,1,11,11,23,0,22,0,0.000,,
7,NA,1301,2,2,2,0,0,4,0,0,0,0.000,,
7,NA,1302,3,2,4,7,7,15,0,14,0,0.000,,
7,NA,1303,2.5,2,3,8,8,18,0,16,0,0.000,,
7,NA,1304,3,4,2,0,0,16,0,0,0,0.000,,
7,NA,1305,2.5,2,3,7,7,14,0,14,0,0.000,,
7,NA,1306,1.5,1,2,2,2,12,0,4,0,0.000,,
7,NA,1307,2.5,2,3,13,13,28,0,26,0,0.000,,
7,NA,1308,3.5,4,3,9,9,20,0,18,0,0.000,,
7,NA,1309,2,2,2,11,11,23,0,22,0,0.000,,
7,NA,1310,3.5,3,4,8,8,24,0,16,0,0.000,,
7,NA,1311,2,3,1,5,5,10,0,10,0,0.000,,
7,NA,1312,2.5,4,1,9,9,19,0,18,0,0.000,,
7,NA,1313,3.5,4,3,0,0,12,0,0,0,0.000,,
7,NA,1314,1.5,2,1,11,11,25,0,22,0,0.000,,
7,NA,1315,4.5,4,5,7,7,16,0,14,0,0.000,,
7,NA,1316,4.5,4,5,6,6,13,0,12,0,0.000,,
7,NA,1317,2,2,2,6,6,15,0,12,0,0.000,,
7,NA,1318,4,3,5,15,15,32,0,30,0,0.000,,
7,NA,1319,3.5,3,4,6,6,16,0,12,0,0.000,,
7,NA,1320,2.5,4,1,9,9,22,0,18,0,0.000,,
7,NA,1321,4,4,4,9,9,22,0,18,0,0.000,,
7,NA,1322,2,2,2,8,8,19,0,16,0,0.000,,
7,NA,1323,2,2,2,10,10,22,0,20,0,0.000,,
7,NA,1324,2.5,4,1,3,3,8,0,6,0,0.000,,
7,NA,1325,2.5,4,1,7,7,15,0,14,0,0.000,,
7,NA,1326,2.5,4,1,0,0,16,0,0,0,0.000,,
7,NA,1327,2,2,2,6,6,18,0,12,0,0.000,,
7,NA,1328,3.5,3,4,7,7,21,0,14,0,0.000,,
7,NA,1329,3,1,5,4,4,11,0,8,0,0.000,,
7,NA,1330,4,4,4,14,14,31,0,28,0,0.000,,
7,NA,1331,2.5,3,2,7,7,15,0,14,0,0.000,,
7,NA,1332,3,4,2,10,10,21,0,20,0,0.000,,
7,NA,1333,2,2,2,6,6,16,0,12,0,0.000,,
7,NA,1334,3.5,4,3,10,10,23,0,20,0,0.000,,
7,NA,1335,3,2,4,7,7,19,0,14,0,0.000,,
7,NA,1336,3.5,3,4,7,7,15,0,14,0,0.000,,
7,NA,1337,5,5,5,0,0,24,0,0,0,0.000,,
7,NA,1338,2.5,3,2,2,2,22,0,4,0,0.000,,
7,NA,1339,5,5,5,6,6,13,0,12,0,0.000,,
7,NA,1340,4,4,4,7,7,15,0,14,0,0.000,,
7,NA,1341,4.5,4,5,0,0,0,0,0,0,0.000,,
7,NA,1342,4,4,4,9,9,20,0,18,0,0.000,,
7,NA,1343,3,2,4,8,8,16,0,16,0,0.000,,
7,NA,1344,4.5,5,4,11,11,23,0,22,0,0.000,,
7,NA,1345,2.5,1,4,9,9,18,0,18,0,0.000,,
7,NA,1346,3.5,3,4,8,8,17,0,16,0,0.000,,
7,NA,1347,2,1,3,9,9,18,0,18,0,0.000,,
7,NA,1348,1.5,1,2,9,9,20,0,18,0,0.000,,
7,NA,1349,2.5,3,2,6,6,13,0,12,0,0.000,,
7,NA,1350,1,1,1,9,9,20,0,18,0,0.000,,
7,NA,1351,3,4,2,0,0,0,0,0,0,0.000,,
7,NA,1352,3,3,3,0,0,0,0,0,0,0.000,,
7,NA,1353,2,3,1,10,10,24,0,20,0,0.000,,
7,NA,1354,3.5,2,5,9,9,18,0,18,0,0.000,,
7,NA,1355,3,3,3,0,0,0,0,0,0,0.000,,
7,NA,1356,3,2,4,12,12,28,0,24,0,0.000,,
7,NA,1357,2.5,3,2,8,8,19,0,16,0,0.000,,
7,NA,1358,3.5,4,3,13,13,28,0,26,0,0.000,,
7,NA,1359,4.5,4,5,14,14,28,0,28,0,0.000,,
7,NA,1360,2.5,3,2,0,0,34,0,0,0,0.000,,
7,NA,1361,4,4,4,13,13,26,0,26,0,0.000,,
7,NA,1362,3.5,5,2,1,1,29,0,2,0,0.000,,
7,NA,1363,1,1,1,10,10,22,0,20,0,0.000,,
7,NA,1364,2.5,2,3,13,13,28,0,26,0,0.000,,
7,NA,1365,2.5,3,2,15,15,32,0,30,0,0.000,,
7,NA,1366,3,4,2,8,8,17,0,16,0,0.000,,
7,NA,1367,3.5,4,3,11,11,24,0,22,0,0.000,,
7,NA,1368,1,1,1,14,14,30,0,28,0,0.000,,
7,NA,1369,3,4,2,0,0,21,0,0,0,0.000,,
7,NA,1370,4,3,5,10,10,20,0,20,0,0.000,,
7,NA,1371,2.5,2,3,16,16,32,0,32,0,0.000,,
7,NA,1372,3.5,3,4,4,4,9,0,8,0,0.000,,
7,NA,1373,1.5,2,1,19,19,42,0,38,0,0.000,,
7,NA,1374,5,5,5,8,8,26,0,16,0,0.000,,
7,NA,1375,4.5,4,5,7,7,17,0,14,0,0.000,,
7,NA,1376,3,5,1,0,0,19,0,0,0,0.000,,
7,NA,1377,4.5,4,5,8,8,22,0,16,0,0.000,,
7,NA,1378,3.5,2,5,15,15,34,0,30,0,0.000,,
7,NA,1379,3.5,3,4,11,11,23,0,22,0,0.000,,
7,NA,1380,2,2,2,13,13,27,0,26,0,0.000,,
7,NA,1381,3,5,1,0,0,0,0,0,0,0.000,,
7,NA,1382,3,5,1,11,11,25,0,22,0,0.000,,
7,NA,1383,3.5,3,4,11,11,23,0,22,0,0.000,,
7,NA,1384,3.5,4,3,3,3,7,0,6,0,0.000,,
7,NA,1385,4,4,4,0,0,0,0,0,0,0.000,,
7,NA,1386,4,3,5,9,9,21,0,18,0,0.000,,
7,NA,1387,3,4,2,8,8,18,0,16,0,0.000,,
7,NA,1388,2,2,2,13,13,27,0,26,0,0.000,,
7,NA,1389,1.5,2,1,13,13,32,0,26,0,0.000,,
7,NA,1390,2,2,2,8,8,21,0,16,0,0.000,,
7,NA,1391,2,3,1,5,5,11,0,10,0,0.000,,
7,NA,1392,2,3,1,10,10,23,0,20,0,0.000,,
7,NA,1393,2.5,4,1,0,0,16,0,0,0,0.000,,
7,NA,1394,4,5,3,0,0,0,0,0,0,0.000,,
7,NA,1395,3,5,1,3,3,17,0,6,0,0.000,,
7,NA,1396,2.5,3,2,7,7,18,0,14,0,0.000,,
7,NA,1397,5,5,5,15,15,31,0,30,0,0.000,,
7,NA,1398,1.5,2,1,11,11,24,0,22,0,0.000,,
7,NA,1399,2.5,3,2,6,6,13,0,12,0,0.000,,
7,NA,1400,2.5,4,1,12,12,24,0,24,0,0.000,,
7,NA,1401,3,3,3,8,8,20,0,16,0,0.000,,
7,NA,1402,2.5,4,1,7,7,16,0,14,0,0.000,,
7,NA,1403,4,4,4,9,9,19,0,18,0,0.000,,
7,NA,1404,2,1,3,7,7,18,0,14,0,0.000,,
7,NA,1405,3.5,5,2,8,8,19,0,16,0,0.000,,
7,NA,1406,2.5,2,3,0,0,21,0,0,0,0.000,,
7,NA,1407,2,1,3,6,6,14,0,12,0,0.000,,
7,NA,1408,3.5,5,2,0,0,17,0,0,0,0.000,,
7,NA,1409,3,1,5,11,11,33,0,22,0,0.000,,
7,NA,1410,2,2,2,6,6,16,0,12,0,0.000,,
7,NA,1411,2.5,3,2,11,11,23,0,22,0,0.000,,
7,NA,1412,3,5,1,0,0,13,0,0,0,0.000,,
7,NA,1413,3,3,3,12,12,29,0,24,0,0.000,,
7,NA,1414,3.5,2,5,10,10,21,0,20,0,0.000,,
7,NA,1415,2.5,2,3,0,0,19,0,0,0,0.000,,
7,NA,1416,2.5,4,1,19,19,41,0,38,0,0.000,,
7,NA,1417,1.5,2,1,11,11,25,0,22,0,0.000,,
7,NA,1418,3,4,2,7,7,14,0,14,0,0.000,,
7,NA,1419,3,3,3,0,0,0,0,0,0,0.000,,
7,NA,1420,1,1,1,8,8,20,0,16,0,0.000,,
7,NA,1421,3.5,3,4,5,5,11,0,10,0,0.000,,
7,NA,1422,5,5,5,9,9,23,0,18,0,0.000,,
7,NA,1423,4,3,5,4,4,8,0,8,0,0.000,,
7,NA,1424,2.5,3,2,8,8,18,0,16,0,0.000,,
7,NA,1425,3,3,3,5,5,12,0,10,0,0.000,,
7,NA,1426,4.5,4,5,12,12,26,0,24,0,0.000,,
7,NA,1427,2.5,3,2,0,0,0,0,0,0,0.000,,
7,NA,1428,4,5,3,8,8,16,0,16,0,0.000,,
7,NA,1429,2.5,4,1,8,8,16,0,16,0,0.000,,
7,NA,1430,1.5,2,1,6,6,15,0,12,0,0.000,,
7,NA,1431,1,1,1,14,14,28,0,28,0,0.000,,
7,NA,1432,3,5,1,9,9,21,0,18,0,0.000,,
7,NA,1433,2.5,2,3,10,10,21,0,20,0,0.000,,
7,NA,1434,4.5,4,5,7,7,18,0,14,0,0.000,,
7,NA,1435,3.5,3,4,0,1,29,-1,1,-1,-0.002,,
7,NA,1436,1,1,1,0,1,1,-1,1,-1,-0.002,,
7,NA,1437,4,4,4,0,1,13,-1,1,-1,-0.002,,
7,NA,1438,2,1,3,0,1,17,-1,1,-1,-0.002,,
7,NA,1439,2.5,2,3,0,1,17,-1,1,-1,-0.002,,
7,NA,1440,4,3,5,0,1,1,-1,1,-1,-0.002,,
7,NA,1441,4,5,3,0,1,36,-1,1,-1,-0.002,,
7,NA,1442,3,1,5,0,1,1,-1,1,-1,-0.002,,
7,NA,1443,3,3,3,0,1,20,-1,1,-1,-0.002,,
7,NA,1444,4,5,3,0,1,24,-1,1,-1,-0.002,,
7,NA,1445,1,1,1,0,1,13,-1,1,-1,-0.002,,
7,NA,1446,2,1,3,0,1,7,-1,1,-1,-0.002,,
7,NA,1447,3,4,2,0,1,30,-1,1,-1,-0.002,,
7,NA,1448,3.5,4,3,1,2,4,-1,3,-3,-0.005,,
7,NA,1449,1,1,1,1,2,3,-1,3,-3,-0.005,,
7,NA,1450,2.5,3,2,1,2,6,-1,3,-3,-0.005,,
7,NA,1451,3.5,3,4,1,2,6,-1,3,-3,-0.005,,
7,NA,1452,2.5,4,1,1,2,28,-1,3,-3,-0.005,,
7,NA,1453,1.5,1,2,0,2,2,-2,2,-4,-0.007,,
7,NA,1454,2.5,3,2,2,3,8,-1,5,-5,-0.009,,
7,NA,1455,3,3,3,2,3,5,-1,5,-5,-0.009,,
7,NA,1456,3,3,3,2,3,7,-1,5,-5,-0.009,,
7,NA,1457,3,3,3,2,3,6,-1,5,-5,-0.009,,
7,NA,1458,5,5,5,2,3,7,-1,5,-5,-0.009,,
7,NA,1459,2.5,4,1,2,3,5,-1,5,-5,-0.009,,
7,NA,1460,4,4,4,2,3,5,-1,5,-5,-0.009,,
7,NA,1461,2.5,3,2,2,3,8,-1,5,-5,-0.009,,
7,NA,1462,2,3,1,2,3,31,-1,5,-5,-0.009,,
7,NA,1463,3.5,3,4,3,4,9,-1,7,-7,-0.012,,
7,NA,1464,2,2,2,3,4,7,-1,7,-7,-0.012,,
7,NA,1465,3,1,5,3,4,7,-1,7,-7,-0.012,,
7,NA,1466,3,4,2,3,4,7,-1,7,-7,-0.012,,
7,NA,1467,1,1,1,3,4,7,-1,7,-7,-0.012,,
7,NA,1468,3.5,2,5,4,5,11,-1,9,-9,-0.016,,
7,NA,1469,2.5,3,2,4,5,9,-1,9,-9,-0.016,,
7,NA,1470,2.5,3,2,4,5,11,-1,9,-9,-0.016,,
7,NA,1471,4,3,5,4,5,10,-1,9,-9,-0.016,,
7,NA,1472,3,2,4,4,5,9,-1,9,-9,-0.016,,
7,NA,1473,2,3,1,4,5,10,-1,9,-9,-0.016,,
7,NA,1474,3,5,1,4,5,10,-1,9,-9,-0.016,,
7,NA,1475,2.5,4,1,4,5,9,-1,9,-9,-0.016,,
7,NA,1476,1.5,1,2,0,3,24,-3,3,-9,-0.016,,
7,NA,1477,4.5,4,5,4,5,9,-1,9,-9,-0.016,,
7,NA,1478,4,3,5,4,5,10,-1,9,-9,-0.016,,
7,NA,1479,2,3,1,4,5,9,-1,9,-9,-0.016,,
7,NA,1480,3,4,2,4,5,11,-1,9,-9,-0.016,,
7,NA,1481,2.5,3,2,5,6,13,-1,11,-11,-0.019,,
7,NA,1482,3,3,3,5,6,15,-1,11,-11,-0.019,,
7,NA,1483,2.5,3,2,5,6,11,-1,11,-11,-0.019,,
7,NA,1484,2.5,3,2,5,6,12,-1,11,-11,-0.019,,
7,NA,1485,4.5,4,5,5,6,12,-1,11,-11,-0.019,,
7,NA,1486,5,5,5,5,6,13,-1,11,-11,-0.019,,
7,NA,1487,3,2,4,5,6,11,-1,11,-11,-0.019,,
7,NA,1488,2.5,2,3,5,6,15,-1,11,-11,-0.019,,
7,NA,1489,3.5,5,2,5,6,12,-1,11,-11,-0.019,,
7,NA,1490,4.5,5,4,5,6,12,-1,11,-11,-0.019,,
7,NA,1491,2.5,3,2,5,6,25,-1,11,-11,-0.019,,
7,NA,1492,3.5,2,5,5,6,16,-1,11,-11,-0.019,,
7,NA,1493,1.5,1,2,5,6,12,-1,11,-11,-0.019,,
7,NA,1494,2.5,1,4,5,6,11,-1,11,-11,-0.019,,
7,NA,1495,2.5,3,2,5,6,12,-1,11,-11,-0.019,,
7,NA,1496,3.5,2,5,5,6,22,-1,11,-11,-0.019,,
7,NA,1497,4.5,4,5,5,6,11,-1,11,-11,-0.019,,
7,NA,1498,4.5,4,5,5,6,13,-1,11,-11,-0.019,,
7,NA,1499,2,3,1,5,6,14,-1,11,-11,-0.019,,
7,NA,1500,3.5,3,4,2,4,8,-2,6,-12,-0.021,,
7,NA,1501,2.5,3,2,2,4,6,-2,6,-12,-0.021,,
7,NA,1502,2.5,3,2,2,4,6,-2,6,-12,-0.021,,
7,NA,1503,4.5,4,5,2,4,6,-2,6,-12,-0.021,,
7,NA,1504,3,1,5,2,4,6,-2,6,-12,-0.021,,
7,NA,1505,3.5,2,5,2,4,6,-2,6,-12,-0.021,,
7,NA,1506,3,3,3,2,4,6,-2,6,-12,-0.021,,
7,NA,1507,2.5,4,1,2,4,8,-2,6,-12,-0.021,,
7,NA,1508,2.5,2,3,2,4,7,-2,6,-12,-0.021,,
7,NA,1509,2.5,3,2,6,7,14,-1,13,-13,-0.023,,
7,NA,1510,2.5,2,3,6,7,14,-1,13,-13,-0.023,,
7,NA,1511,3.5,2,5,6,7,15,-1,13,-13,-0.023,,
7,NA,1512,3.5,4,3,6,7,16,-1,13,-13,-0.023,,
7,NA,1513,2,3,1,6,7,13,-1,13,-13,-0.023,,
7,NA,1514,2,1,3,6,7,14,-1,13,-13,-0.023,,
7,NA,1515,3,5,1,6,7,14,-1,13,-13,-0.023,,
7,NA,1516,2.5,3,2,6,7,14,-1,13,-13,-0.023,,
7,NA,1517,5,5,5,6,7,16,-1,13,-13,-0.023,,
7,NA,1518,4,3,5,6,7,14,-1,13,-13,-0.023,,
7,NA,1519,3,3,3,6,7,16,-1,13,-13,-0.023,,
7,NA,1520,4,5,3,6,7,14,-1,13,-13,-0.023,,
7,NA,1521,3,4,2,6,7,14,-1,13,-13,-0.023,,
7,NA,1522,4,5,3,6,7,14,-1,13,-13,-0.023,,
7,NA,1523,3,2,4,6,7,14,-1,13,-13,-0.023,,
7,NA,1524,3,4,2,6,7,17,-1,13,-13,-0.023,,
7,NA,1525,4,3,5,6,7,14,-1,13,-13,-0.023,,
7,NA,1526,2,1,3,6,7,13,-1,13,-13,-0.023,,
7,NA,1527,2.5,3,2,6,7,13,-1,13,-13,-0.023,,
7,NA,1528,2.5,1,4,6,7,16,-1,13,-13,-0.023,,
7,NA,1529,2,2,2,6,7,15,-1,13,-13,-0.023,,
7,NA,1530,3,4,2,6,7,16,-1,13,-13,-0.023,,
7,NA,1531,3,3,3,6,7,13,-1,13,-13,-0.023,,
7,NA,1532,2.5,3,2,6,7,14,-1,13,-13,-0.023,,
7,NA,1533,3,5,1,6,7,16,-1,13,-13,-0.023,,
7,NA,1534,1.5,2,1,6,7,14,-1,13,-13,-0.023,,
7,NA,1535,2.5,3,2,6,7,16,-1,13,-13,-0.023,,
7,NA,1536,2,2,2,6,7,14,-1,13,-13,-0.023,,
7,NA,1537,2.5,2,3,6,7,13,-1,13,-13,-0.023,,
7,NA,1538,3.5,3,4,6,7,13,-1,13,-13,-0.023,,
7,NA,1539,2,1,3,7,8,17,-1,15,-15,-0.026,,
7,NA,1540,2,3,1,1,4,5,-3,5,-15,-0.026,,
7,NA,1541,5,5,5,7,8,17,-1,15,-15,-0.026,,
7,NA,1542,3.5,3,4,7,8,16,-1,15,-15,-0.026,,
7,NA,1543,3,4,2,7,8,17,-1,15,-15,-0.026,,
7,NA,1544,4.5,4,5,7,8,15,-1,15,-15,-0.026,,
7,NA,1545,2.5,1,4,1,4,6,-3,5,-15,-0.026,,
7,NA,1546,3,2,4,7,8,15,-1,15,-15,-0.026,,
7,NA,1547,3.5,3,4,7,8,16,-1,15,-15,-0.026,,
7,NA,1548,3,3,3,7,8,16,-1,15,-15,-0.026,,
7,NA,1549,3.5,4,3,7,8,16,-1,15,-15,-0.026,,
7,NA,1550,2.5,1,4,7,8,16,-1,15,-15,-0.026,,
7,NA,1551,4,4,4,7,8,16,-1,15,-15,-0.026,,
7,NA,1552,4.5,4,5,7,8,15,-1,15,-15,-0.026,,
7,NA,1553,2,2,2,7,8,15,-1,15,-15,-0.026,,
7,NA,1554,3,4,2,7,8,16,-1,15,-15,-0.026,,
7,NA,1555,4,3,5,7,8,18,-1,15,-15,-0.026,,
7,NA,1556,2.5,3,2,7,8,15,-1,15,-15,-0.026,,
7,NA,1557,2.5,3,2,7,8,20,-1,15,-15,-0.026,,
7,NA,1558,3,4,2,7,8,17,-1,15,-15,-0.026,,
7,NA,1559,3,4,2,7,8,15,-1,15,-15,-0.026,,
7,NA,1560,3,2,4,7,8,17,-1,15,-15,-0.026,,
7,NA,1561,1.5,2,1,7,8,16,-1,15,-15,-0.026,,
7,NA,1562,4.5,5,4,7,8,15,-1,15,-15,-0.026,,
7,NA,1563,3,5,1,7,8,17,-1,15,-15,-0.026,,
7,NA,1564,2.5,3,2,7,8,15,-1,15,-15,-0.026,,
7,NA,1565,3.5,3,4,7,8,15,-1,15,-15,-0.026,,
7,NA,1566,4,3,5,7,8,17,-1,15,-15,-0.026,,
7,NA,1567,4,3,5,7,8,15,-1,15,-15,-0.026,,
7,NA,1568,3,2,4,7,8,20,-1,15,-15,-0.026,,
7,NA,1569,4,3,5,7,8,16,-1,15,-15,-0.026,,
7,NA,1570,1,1,1,7,8,16,-1,15,-15,-0.026,,
7,NA,1571,4,4,4,3,5,9,-2,8,-16,-0.028,,
7,NA,1572,2.5,3,2,3,5,11,-2,8,-16,-0.028,,
7,NA,1573,3.5,4,3,3,5,8,-2,8,-16,-0.028,,
7,NA,1574,3,3,3,3,5,8,-2,8,-16,-0.028,,
7,NA,1575,4,4,4,3,5,11,-2,8,-16,-0.028,,
7,NA,1576,3,1,5,3,5,9,-2,8,-16,-0.028,,
7,NA,1577,3.5,3,4,3,5,10,-2,8,-16,-0.028,,
7,NA,1578,3.5,4,3,3,5,14,-2,8,-16,-0.028,,
7,NA,1579,2.5,2,3,3,5,10,-2,8,-16,-0.028,,
7,NA,1580,2.5,1,4,3,5,12,-2,8,-16,-0.028,,
7,NA,1581,2,3,1,3,5,9,-2,8,-16,-0.028,,
7,NA,1582,3.5,3,4,3,5,8,-2,8,-16,-0.028,,
7,NA,1583,2,2,2,8,9,19,-1,17,-17,-0.030,,
7,NA,1584,3,1,5,8,9,18,-1,17,-17,-0.030,,
7,NA,1585,4,4,4,8,9,18,-1,17,-17,-0.030,,
7,NA,1586,3,4,2,8,9,18,-1,17,-17,-0.030,,
7,NA,1587,3,1,5,8,9,22,-1,17,-17,-0.030,,
7,NA,1588,2.5,2,3,8,9,19,-1,17,-17,-0.030,,
7,NA,1589,3.5,2,5,8,9,19,-1,17,-17,-0.030,,
7,NA,1590,3.5,2,5,8,9,17,-1,17,-17,-0.030,,
7,NA,1591,3,4,2,8,9,18,-1,17,-17,-0.030,,
7,NA,1592,2,2,2,8,9,20,-1,17,-17,-0.030,,
7,NA,1593,3.5,3,4,8,9,21,-1,17,-17,-0.030,,
7,NA,1594,3,4,2,8,9,17,-1,17,-17,-0.030,,
7,NA,1595,4,4,4,8,9,19,-1,17,-17,-0.030,,
7,NA,1596,3.5,5,2,8,9,18,-1,17,-17,-0.030,,
7,NA,1597,3.5,3,4,8,9,17,-1,17,-17,-0.030,,
7,NA,1598,2,3,1,8,9,17,-1,17,-17,-0.030,,
7,NA,1599,3,3,3,8,9,18,-1,17,-17,-0.030,,
7,NA,1600,3.5,3,4,8,9,20,-1,17,-17,-0.030,,
7,NA,1601,4.5,4,5,8,9,18,-1,17,-17,-0.030,,
7,NA,1602,3.5,3,4,8,9,19,-1,17,-17,-0.030,,
7,NA,1603,3,5,1,8,9,20,-1,17,-17,-0.030,,
7,NA,1604,3,4,2,8,9,18,-1,17,-17,-0.030,,
7,NA,1605,2.5,2,3,8,9,17,-1,17,-17,-0.030,,
7,NA,1606,2,3,1,8,9,20,-1,17,-17,-0.030,,
7,NA,1607,3,4,2,8,9,18,-1,17,-17,-0.030,,
7,NA,1608,3.5,4,3,8,9,18,-1,17,-17,-0.030,,
7,NA,1609,3.5,2,5,8,9,19,-1,17,-17,-0.030,,
7,NA,1610,4.5,4,5,8,9,19,-1,17,-17,-0.030,,
7,NA,1611,2,2,2,8,9,20,-1,17,-17,-0.030,,
7,NA,1612,3,4,2,8,9,18,-1,17,-17,-0.030,,
7,NA,1613,1.5,1,2,8,9,21,-1,17,-17,-0.030,,
7,NA,1614,3.5,4,3,9,10,21,-1,19,-19,-0.033,,
7,NA,1615,3,3,3,9,10,20,-1,19,-19,-0.033,,
7,NA,1616,4,5,3,9,10,19,-1,19,-19,-0.033,,
7,NA,1617,3,3,3,9,10,20,-1,19,-19,-0.033,,
7,NA,1618,3,4,2,9,10,20,-1,19,-19,-0.033,,
7,NA,1619,2.5,2,3,9,10,22,-1,19,-19,-0.033,,
7,NA,1620,3,3,3,9,10,21,-1,19,-19,-0.033,,
7,NA,1621,2.5,3,2,9,10,19,-1,19,-19,-0.033,,
7,NA,1622,4,4,4,9,10,20,-1,19,-19,-0.033,,
7,NA,1623,3,2,4,9,10,21,-1,19,-19,-0.033,,
7,NA,1624,2.5,1,4,9,10,21,-1,19,-19,-0.033,,
7,NA,1625,4,3,5,9,10,22,-1,19,-19,-0.033,,
7,NA,1626,4,4,4,9,10,22,-1,19,-19,-0.033,,
7,NA,1627,2,2,2,9,10,20,-1,19,-19,-0.033,,
7,NA,1628,4.5,4,5,9,10,20,-1,19,-19,-0.033,,
7,NA,1629,2.5,3,2,9,10,19,-1,19,-19,-0.033,,
7,NA,1630,3.5,2,5,9,10,22,-1,19,-19,-0.033,,
7,NA,1631,2.5,3,2,9,10,21,-1,19,-19,-0.033,,
7,NA,1632,2,2,2,9,10,25,-1,19,-19,-0.033,,
7,NA,1633,4.5,4,5,9,10,19,-1,19,-19,-0.033,,
7,NA,1634,1.5,1,2,9,10,19,-1,19,-19,-0.033,,
7,NA,1635,3.5,2,5,9,10,24,-1,19,-19,-0.033,,
7,NA,1636,3,4,2,9,10,22,-1,19,-19,-0.033,,
7,NA,1637,2.5,4,1,9,10,27,-1,19,-19,-0.033,,
7,NA,1638,2.5,2,3,9,10,21,-1,19,-19,-0.033,,
7,NA,1639,4,3,5,9,10,21,-1,19,-19,-0.033,,
7,NA,1640,2,3,1,9,10,21,-1,19,-19,-0.033,,
7,NA,1641,3.5,3,4,9,10,22,-1,19,-19,-0.033,,
7,NA,1642,2,1,3,9,10,24,-1,19,-19,-0.033,,
7,NA,1643,2.5,3,2,9,10,19,-1,19,-19,-0.033,,
7,NA,1644,4.5,5,4,9,10,20,-1,19,-19,-0.033,,
7,NA,1645,2.5,3,2,9,10,19,-1,19,-19,-0.033,,
7,NA,1646,1.5,1,2,9,10,24,-1,19,-19,-0.033,,
7,NA,1647,2,3,1,9,10,21,-1,19,-19,-0.033,,
7,NA,1648,4,5,3,9,10,20,-1,19,-19,-0.033,,
7,NA,1649,3,4,2,9,10,20,-1,19,-19,-0.033,,
7,NA,1650,2,3,1,9,10,22,-1,19,-19,-0.033,,
7,NA,1651,3.5,4,3,9,10,24,-1,19,-19,-0.033,,
7,NA,1652,4.5,4,5,9,10,21,-1,19,-19,-0.033,,
7,NA,1653,3,3,3,4,6,12,-2,10,-20,-0.035,,
7,NA,1654,1.5,2,1,4,6,12,-2,10,-20,-0.035,,
7,NA,1655,4,4,4,4,6,10,-2,10,-20,-0.035,,
7,NA,1656,3.5,3,4,4,6,11,-2,10,-20,-0.035,,
7,NA,1657,2.5,1,4,4,6,10,-2,10,-20,-0.035,,
7,NA,1658,4,4,4,4,6,11,-2,10,-20,-0.035,,
7,NA,1659,3.5,2,5,4,6,10,-2,10,-20,-0.035,,
7,NA,1660,2.5,3,2,4,6,12,-2,10,-20,-0.035,,
7,NA,1661,3.5,3,4,4,6,11,-2,10,-20,-0.035,,
7,NA,1662,4,5,3,4,6,15,-2,10,-20,-0.035,,
7,NA,1663,3,2,4,4,6,10,-2,10,-20,-0.035,,
7,NA,1664,3,1,5,4,6,11,-2,10,-20,-0.035,,
7,NA,1665,3,3,3,4,6,12,-2,10,-20,-0.035,,
7,NA,1666,2,2,2,10,11,23,-1,21,-21,-0.036,,
7,NA,1667,2.5,3,2,2,5,8,-3,7,-21,-0.036,,
7,NA,1668,5,5,5,10,11,25,-1,21,-21,-0.036,,
7,NA,1669,2.5,3,2,10,11,22,-1,21,-21,-0.036,,
7,NA,1670,2.5,4,1,2,5,8,-3,7,-21,-0.036,,
7,NA,1671,3,2,4,10,11,22,-1,21,-21,-0.036,,
7,NA,1672,3.5,3,4,10,11,22,-1,21,-21,-0.036,,
7,NA,1673,3,2,4,10,11,26,-1,21,-21,-0.036,,
7,NA,1674,4,3,5,10,11,24,-1,21,-21,-0.036,,
7,NA,1675,4,3,5,10,11,22,-1,21,-21,-0.036,,
7,NA,1676,4.5,4,5,10,11,22,-1,21,-21,-0.036,,
7,NA,1677,4.5,4,5,10,11,22,-1,21,-21,-0.036,,
7,NA,1678,2.5,3,2,10,11,27,-1,21,-21,-0.036,,
7,NA,1679,3.5,3,4,10,11,22,-1,21,-21,-0.036,,
7,NA,1680,3.5,3,4,10,11,26,-1,21,-21,-0.036,,
7,NA,1681,4.5,4,5,10,11,22,-1,21,-21,-0.036,,
7,NA,1682,3,1,5,10,11,24,-1,21,-21,-0.036,,
7,NA,1683,3.5,4,3,10,11,25,-1,21,-21,-0.036,,
7,NA,1684,4,4,4,10,11,23,-1,21,-21,-0.036,,
7,NA,1685,2.5,2,3,10,11,25,-1,21,-21,-0.036,,
7,NA,1686,4,4,4,10,11,23,-1,21,-21,-0.036,,
7,NA,1687,3,3,3,10,11,22,-1,21,-21,-0.036,,
7,NA,1688,4,3,5,10,11,24,-1,21,-21,-0.036,,
7,NA,1689,2,2,2,10,11,23,-1,21,-21,-0.036,,
7,NA,1690,1,1,1,10,11,22,-1,21,-21,-0.036,,
7,NA,1691,3,3,3,10,11,23,-1,21,-21,-0.036,,
7,NA,1692,3,3,3,10,11,22,-1,21,-21,-0.036,,
7,NA,1693,3,4,2,10,11,25,-1,21,-21,-0.036,,
7,NA,1694,4,3,5,10,11,22,-1,21,-21,-0.036,,
7,NA,1695,5,5,5,10,11,21,-1,21,-21,-0.036,,
7,NA,1696,4,3,5,11,12,25,-1,23,-23,-0.040,,
7,NA,1697,3,2,4,11,12,23,-1,23,-23,-0.040,,
7,NA,1698,3.5,2,5,11,12,26,-1,23,-23,-0.040,,
7,NA,1699,3.5,3,4,11,12,24,-1,23,-23,-0.040,,
7,NA,1700,3.5,2,5,11,12,24,-1,23,-23,-0.040,,
7,NA,1701,3.5,3,4,11,12,26,-1,23,-23,-0.040,,
7,NA,1702,2.5,1,4,11,12,26,-1,23,-23,-0.040,,
7,NA,1703,2,2,2,11,12,26,-1,23,-23,-0.040,,
7,NA,1704,5,5,5,11,12,26,-1,23,-23,-0.040,,
7,NA,1705,3.5,3,4,11,12,25,-1,23,-23,-0.040,,
7,NA,1706,3,5,1,11,12,26,-1,23,-23,-0.040,,
7,NA,1707,2.5,3,2,11,12,26,-1,23,-23,-0.040,,
7,NA,1708,2,3,1,11,12,25,-1,23,-23,-0.040,,
7,NA,1709,5,5,5,11,12,23,-1,23,-23,-0.040,,
7,NA,1710,2.5,3,2,5,7,12,-2,12,-24,-0.042,,
7,NA,1711,4,3,5,5,7,13,-2,12,-24,-0.042,,
7,NA,1712,2.5,2,3,1,5,6,-4,6,-24,-0.042,,
7,NA,1713,2,2,2,1,5,8,-4,6,-24,-0.042,,
7,NA,1714,3,1,5,5,7,16,-2,12,-24,-0.042,,
7,NA,1715,4.5,4,5,5,7,12,-2,12,-24,-0.042,,
7,NA,1716,3,2,4,5,7,15,-2,12,-24,-0.042,,
7,NA,1717,2.5,3,2,5,7,14,-2,12,-24,-0.042,,
7,NA,1718,1.5,1,2,5,7,13,-2,12,-24,-0.042,,
7,NA,1719,3.5,3,4,5,7,13,-2,12,-24,-0.042,,
7,NA,1720,3.5,3,4,5,7,16,-2,12,-24,-0.042,,
7,NA,1721,2,1,3,5,7,13,-2,12,-24,-0.042,,
7,NA,1722,3.5,4,3,5,7,14,-2,12,-24,-0.042,,
7,NA,1723,4,5,3,5,7,17,-2,12,-24,-0.042,,
7,NA,1724,3.5,4,3,5,7,12,-2,12,-24,-0.042,,
7,NA,1725,1,1,1,5,7,15,-2,12,-24,-0.042,,
7,NA,1726,4,4,4,5,7,13,-2,12,-24,-0.042,,
7,NA,1727,2.5,3,2,12,13,27,-1,25,-25,-0.043,,
7,NA,1728,3.5,3,4,12,13,25,-1,25,-25,-0.043,,
7,NA,1729,3,2,4,12,13,26,-1,25,-25,-0.043,,
7,NA,1730,2.5,3,2,12,13,27,-1,25,-25,-0.043,,
7,NA,1731,4.5,4,5,12,13,27,-1,25,-25,-0.043,,
7,NA,1732,2,1,3,12,13,28,-1,25,-25,-0.043,,
7,NA,1733,2,2,2,12,13,28,-1,25,-25,-0.043,,
7,NA,1734,3,2,4,12,13,27,-1,25,-25,-0.043,,
7,NA,1735,2.5,3,2,12,13,27,-1,25,-25,-0.043,,
7,NA,1736,2.5,3,2,12,13,27,-1,25,-25,-0.043,,
7,NA,1737,5,5,5,12,13,30,-1,25,-25,-0.043,,
7,NA,1738,2.5,3,2,12,13,26,-1,25,-25,-0.043,,
7,NA,1739,3,4,2,12,13,25,-1,25,-25,-0.043,,
7,NA,1740,4.5,4,5,12,13,28,-1,25,-25,-0.043,,
7,NA,1741,3,2,4,12,13,28,-1,25,-25,-0.043,,
7,NA,1742,1.5,2,1,12,13,27,-1,25,-25,-0.043,,
7,NA,1743,3.5,5,2,12,13,26,-1,25,-25,-0.043,,
7,NA,1744,3,3,3,12,13,27,-1,25,-25,-0.043,,
7,NA,1745,4,5,3,12,13,27,-1,25,-25,-0.043,,
7,NA,1746,2,3,1,12,13,27,-1,25,-25,-0.043,,
7,NA,1747,3,4,2,3,6,12,-3,9,-27,-0.047,,
7,NA,1748,3,5,1,3,6,11,-3,9,-27,-0.047,,
7,NA,1749,2.5,3,2,13,14,28,-1,27,-27,-0.047,,
7,NA,1750,4,4,4,13,14,29,-1,27,-27,-0.047,,
7,NA,1751,3.5,5,2,13,14,39,-1,27,-27,-0.047,,
7,NA,1752,1,1,1,3,6,10,-3,9,-27,-0.047,,
7,NA,1753,2.5,4,1,13,14,29,-1,27,-27,-0.047,,
7,NA,1754,3,4,2,3,6,10,-3,9,-27,-0.047,,
7,NA,1755,3.5,2,5,3,6,9,-3,9,-27,-0.047,,
7,NA,1756,4,3,5,13,14,27,-1,27,-27,-0.047,,
7,NA,1757,3.5,3,4,3,6,11,-3,9,-27,-0.047,,
7,NA,1758,1.5,1,2,3,6,9,-3,9,-27,-0.047,,
7,NA,1759,4,5,3,13,14,30,-1,27,-27,-0.047,,
7,NA,1760,2.5,3,2,13,14,28,-1,27,-27,-0.047,,
7,NA,1761,2.5,4,1,3,6,12,-3,9,-27,-0.047,,
7,NA,1762,2.5,4,1,3,6,12,-3,9,-27,-0.047,,
7,NA,1763,3,4,2,13,14,29,-1,27,-27,-0.047,,
7,NA,1764,2.5,1,4,3,6,10,-3,9,-27,-0.047,,
7,NA,1765,2.5,1,4,13,14,31,-1,27,-27,-0.047,,
7,NA,1766,5,5,5,13,14,30,-1,27,-27,-0.047,,
7,NA,1767,3,5,1,13,14,32,-1,27,-27,-0.047,,
7,NA,1768,3,4,2,3,6,10,-3,9,-27,-0.047,,
7,NA,1769,4,3,5,13,14,35,-1,27,-27,-0.047,,
7,NA,1770,1.5,2,1,13,14,29,-1,27,-27,-0.047,,
7,NA,1771,3.5,5,2,3,6,17,-3,9,-27,-0.047,,
7,NA,1772,4,5,3,13,14,29,-1,27,-27,-0.047,,
7,NA,1773,1.5,1,2,13,14,29,-1,27,-27,-0.047,,
7,NA,1774,5,5,5,13,14,28,-1,27,-27,-0.047,,
7,NA,1775,3,5,1,13,14,29,-1,27,-27,-0.047,,
7,NA,1776,4,3,5,13,14,29,-1,27,-27,-0.047,,
7,NA,1777,2.5,1,4,6,8,18,-2,14,-28,-0.049,,
7,NA,1778,2,3,1,6,8,16,-2,14,-28,-0.049,,
7,NA,1779,2.5,2,3,6,8,14,-2,14,-28,-0.049,,
7,NA,1780,4,4,4,6,8,14,-2,14,-28,-0.049,,
7,NA,1781,2,2,2,6,8,15,-2,14,-28,-0.049,,
7,NA,1782,4,3,5,6,8,19,-2,14,-28,-0.049,,
7,NA,1783,4.5,5,4,6,8,17,-2,14,-28,-0.049,,
7,NA,1784,3,5,1,6,8,17,-2,14,-28,-0.049,,
7,NA,1785,3.5,4,3,6,8,14,-2,14,-28,-0.049,,
7,NA,1786,2,2,2,6,8,15,-2,14,-28,-0.049,,
7,NA,1787,3,2,4,6,8,17,-2,14,-28,-0.049,,
7,NA,1788,4,4,4,6,8,16,-2,14,-28,-0.049,,
7,NA,1789,3.5,3,4,6,8,14,-2,14,-28,-0.049,,
7,NA,1790,2.5,4,1,6,8,16,-2,14,-28,-0.049,,
7,NA,1791,3,5,1,6,8,16,-2,14,-28,-0.049,,
7,NA,1792,2,2,2,6,8,15,-2,14,-28,-0.049,,
7,NA,1793,2.5,4,1,6,8,16,-2,14,-28,-0.049,,
7,NA,1794,2,2,2,6,8,15,-2,14,-28,-0.049,,
7,NA,1795,3,4,2,6,8,14,-2,14,-28,-0.049,,
7,NA,1796,3.5,2,5,6,8,18,-2,14,-28,-0.049,,
7,NA,1797,5,5,5,6,8,16,-2,14,-28,-0.049,,
7,NA,1798,1,1,1,6,8,14,-2,14,-28,-0.049,,
7,NA,1799,2,1,3,6,8,16,-2,14,-28,-0.049,,
7,NA,1800,3,3,3,6,8,15,-2,14,-28,-0.049,,
7,NA,1801,2,3,1,6,8,17,-2,14,-28,-0.049,,
7,NA,1802,2,3,1,6,8,15,-2,14,-28,-0.049,,
7,NA,1803,3,3,3,6,8,17,-2,14,-28,-0.049,,
7,NA,1804,1.5,1,2,6,8,16,-2,14,-28,-0.049,,
7,NA,1805,3,1,5,6,8,14,-2,14,-28,-0.049,,
7,NA,1806,2,2,2,14,15,32,-1,29,-29,-0.050,,
7,NA,1807,3,1,5,14,15,33,-1,29,-29,-0.050,,
7,NA,1808,3.5,2,5,14,15,30,-1,29,-29,-0.050,,
7,NA,1809,4.5,4,5,14,15,30,-1,29,-29,-0.050,,
7,NA,1810,3,5,1,14,15,34,-1,29,-29,-0.050,,
7,NA,1811,3,5,1,14,15,32,-1,29,-29,-0.050,,
7,NA,1812,1.5,2,1,15,16,31,-1,31,-31,-0.054,,
7,NA,1813,3,3,3,15,16,32,-1,31,-31,-0.054,,
7,NA,1814,4.5,5,4,15,16,32,-1,31,-31,-0.054,,
7,NA,1815,2,3,1,15,16,32,-1,31,-31,-0.054,,
7,NA,1816,3,4,2,15,16,32,-1,31,-31,-0.054,,
7,NA,1817,1,1,1,15,16,33,-1,31,-31,-0.054,,
7,NA,1818,2,1,3,15,16,31,-1,31,-31,-0.054,,
7,NA,1819,4,3,5,15,16,34,-1,31,-31,-0.054,,
7,NA,1820,3.5,5,2,15,16,35,-1,31,-31,-0.054,,
7,NA,1821,1.5,2,1,7,9,20,-2,16,-32,-0.056,,
7,NA,1822,3.5,4,3,2,6,10,-4,8,-32,-0.056,,
7,NA,1823,3.5,5,2,7,9,17,-2,16,-32,-0.056,,
7,NA,1824,3.5,3,4,2,6,9,-4,8,-32,-0.056,,
7,NA,1825,1,1,1,7,9,17,-2,16,-32,-0.056,,
7,NA,1826,4,4,4,7,9,18,-2,16,-32,-0.056,,
7,NA,1827,3.5,3,4,7,9,18,-2,16,-32,-0.056,,
7,NA,1828,2,1,3,7,9,19,-2,16,-32,-0.056,,
7,NA,1829,3,2,4,7,9,16,-2,16,-32,-0.056,,
7,NA,1830,3.5,3,4,7,9,16,-2,16,-32,-0.056,,
7,NA,1831,2.5,4,1,2,6,9,-4,8,-32,-0.056,,
7,NA,1832,2.5,4,1,7,9,19,-2,16,-32,-0.056,,
7,NA,1833,2.5,3,2,7,9,18,-2,16,-32,-0.056,,
7,NA,1834,1,1,1,7,9,19,-2,16,-32,-0.056,,
7,NA,1835,2,3,1,7,9,17,-2,16,-32,-0.056,,
7,NA,1836,4,4,4,7,9,18,-2,16,-32,-0.056,,
7,NA,1837,3.5,3,4,7,9,17,-2,16,-32,-0.056,,
7,NA,1838,3,5,1,2,6,9,-4,8,-32,-0.056,,
7,NA,1839,5,5,5,7,9,16,-2,16,-32,-0.056,,
7,NA,1840,2,3,1,7,9,19,-2,16,-32,-0.056,,
7,NA,1841,1,1,1,7,9,19,-2,16,-32,-0.056,,
7,NA,1842,3,3,3,4,7,11,-3,11,-33,-0.057,,
7,NA,1843,2,3,1,4,7,12,-3,11,-33,-0.057,,
7,NA,1844,2,2,2,4,7,13,-3,11,-33,-0.057,,
7,NA,1845,4.5,5,4,4,7,18,-3,11,-33,-0.057,,
7,NA,1846,3,4,2,4,7,14,-3,11,-33,-0.057,,
7,NA,1847,2,3,1,4,7,12,-3,11,-33,-0.057,,
7,NA,1848,3,3,3,4,7,14,-3,11,-33,-0.057,,
7,NA,1849,3.5,3,4,4,7,13,-3,11,-33,-0.057,,
7,NA,1850,5,5,5,16,17,34,-1,33,-33,-0.057,,
7,NA,1851,4,3,5,4,7,13,-3,11,-33,-0.057,,
7,NA,1852,1,1,1,4,7,12,-3,11,-33,-0.057,,
7,NA,1853,3,4,2,4,7,16,-3,11,-33,-0.057,,
7,NA,1854,3.5,3,4,16,17,34,-1,33,-33,-0.057,,
7,NA,1855,4,5,3,4,7,11,-3,11,-33,-0.057,,
7,NA,1856,2.5,3,2,4,7,11,-3,11,-33,-0.057,,
7,NA,1857,3.5,3,4,4,7,12,-3,11,-33,-0.057,,
7,NA,1858,2,3,1,4,7,15,-3,11,-33,-0.057,,
7,NA,1859,2.5,3,2,16,17,34,-1,33,-33,-0.057,,
7,NA,1860,4.5,5,4,1,6,9,-5,7,-35,-0.061,,
7,NA,1861,1,1,1,17,18,36,-1,35,-35,-0.061,,
7,NA,1862,3,4,2,8,10,19,-2,18,-36,-0.063,,
7,NA,1863,1.5,2,1,8,10,20,-2,18,-36,-0.063,,
7,NA,1864,2,3,1,8,10,20,-2,18,-36,-0.063,,
7,NA,1865,2,3,1,8,10,21,-2,18,-36,-0.063,,
7,NA,1866,2.5,3,2,8,10,19,-2,18,-36,-0.063,,
7,NA,1867,4,3,5,8,10,18,-2,18,-36,-0.063,,
7,NA,1868,2,2,2,8,10,20,-2,18,-36,-0.063,,
7,NA,1869,4,5,3,8,10,20,-2,18,-36,-0.063,,
7,NA,1870,2.5,2,3,8,10,19,-2,18,-36,-0.063,,
7,NA,1871,3,2,4,8,10,19,-2,18,-36,-0.063,,
7,NA,1872,1.5,1,2,8,10,21,-2,18,-36,-0.063,,
7,NA,1873,2,2,2,8,10,20,-2,18,-36,-0.063,,
7,NA,1874,2,2,2,8,10,19,-2,18,-36,-0.063,,
7,NA,1875,2.5,2,3,8,10,18,-2,18,-36,-0.063,,
7,NA,1876,5,5,5,8,10,21,-2,18,-36,-0.063,,
7,NA,1877,2.5,3,2,8,10,21,-2,18,-36,-0.063,,
7,NA,1878,2.5,2,3,8,10,20,-2,18,-36,-0.063,,
7,NA,1879,2.5,3,2,8,10,18,-2,18,-36,-0.063,,
7,NA,1880,2.5,3,2,8,10,18,-2,18,-36,-0.063,,
7,NA,1881,3,4,2,8,10,20,-2,18,-36,-0.063,,
7,NA,1882,3,5,1,8,10,19,-2,18,-36,-0.063,,
7,NA,1883,3,5,1,8,10,22,-2,18,-36,-0.063,,
7,NA,1884,1.5,2,1,8,10,19,-2,18,-36,-0.063,,
7,NA,1885,3.5,4,3,8,10,18,-2,18,-36,-0.063,,
7,NA,1886,2,2,2,8,10,19,-2,18,-36,-0.063,,
7,NA,1887,3.5,5,2,8,10,20,-2,18,-36,-0.063,,
7,NA,1888,3,1,5,8,10,23,-2,18,-36,-0.063,,
7,NA,1889,3,2,4,5,8,16,-3,13,-39,-0.068,,
7,NA,1890,4.5,4,5,5,8,14,-3,13,-39,-0.068,,
7,NA,1891,2.5,3,2,5,8,14,-3,13,-39,-0.068,,
7,NA,1892,2,2,2,5,8,21,-3,13,-39,-0.068,,
7,NA,1893,3,4,2,5,8,13,-3,13,-39,-0.068,,
7,NA,1894,3.5,3,4,5,8,13,-3,13,-39,-0.068,,
7,NA,1895,3.5,4,3,5,8,14,-3,13,-39,-0.068,,
7,NA,1896,1.5,2,1,5,8,17,-3,13,-39,-0.068,,
7,NA,1897,3,4,2,19,20,42,-1,39,-39,-0.068,,
7,NA,1898,4,4,4,5,8,16,-3,13,-39,-0.068,,
7,NA,1899,2.5,4,1,5,8,14,-3,13,-39,-0.068,,
7,NA,1900,3,1,5,19,20,45,-1,39,-39,-0.068,,
7,NA,1901,4,4,4,5,8,13,-3,13,-39,-0.068,,
7,NA,1902,2.5,3,2,5,8,15,-3,13,-39,-0.068,,
7,NA,1903,2,3,1,5,8,15,-3,13,-39,-0.068,,
7,NA,1904,1.5,2,1,9,11,20,-2,20,-40,-0.069,,
7,NA,1905,3,3,3,9,11,25,-2,20,-40,-0.069,,
7,NA,1906,2.5,1,4,9,11,22,-2,20,-40,-0.069,,
7,NA,1907,3.5,4,3,9,11,23,-2,20,-40,-0.069,,
7,NA,1908,3,2,4,3,7,11,-4,10,-40,-0.069,,
7,NA,1909,2,2,2,9,11,21,-2,20,-40,-0.069,,
7,NA,1910,4.5,5,4,9,11,21,-2,20,-40,-0.069,,
7,NA,1911,2,3,1,9,11,22,-2,20,-40,-0.069,,
7,NA,1912,3.5,2,5,9,11,21,-2,20,-40,-0.069,,
7,NA,1913,2.5,2,3,9,11,20,-2,20,-40,-0.069,,
7,NA,1914,4.5,4,5,9,11,25,-2,20,-40,-0.069,,
7,NA,1915,2,1,3,9,11,23,-2,20,-40,-0.069,,
7,NA,1916,4.5,4,5,3,7,12,-4,10,-40,-0.069,,
7,NA,1917,3.5,3,4,9,11,20,-2,20,-40,-0.069,,
7,NA,1918,2.5,1,4,9,11,23,-2,20,-40,-0.069,,
7,NA,1919,3,2,4,9,11,22,-2,20,-40,-0.069,,
7,NA,1920,2,2,2,9,11,23,-2,20,-40,-0.069,,
7,NA,1921,2.5,3,2,9,11,22,-2,20,-40,-0.069,,
7,NA,1922,3.5,3,4,9,11,21,-2,20,-40,-0.069,,
7,NA,1923,3.5,3,4,9,11,22,-2,20,-40,-0.069,,
7,NA,1924,3,1,5,9,11,21,-2,20,-40,-0.069,,
7,NA,1925,2.5,3,2,9,11,24,-2,20,-40,-0.069,,
7,NA,1926,4,3,5,9,11,22,-2,20,-40,-0.069,,
7,NA,1927,3,4,2,9,11,21,-2,20,-40,-0.069,,
7,NA,1928,3.5,2,5,9,11,24,-2,20,-40,-0.069,,
7,NA,1929,4,5,3,9,11,22,-2,20,-40,-0.069,,
7,NA,1930,4,5,3,9,11,22,-2,20,-40,-0.069,,
7,NA,1931,3,4,2,9,11,21,-2,20,-40,-0.069,,
7,NA,1932,1.5,1,2,9,11,24,-2,20,-40,-0.069,,
7,NA,1933,4,3,5,3,7,12,-4,10,-40,-0.069,,
7,NA,1934,2,3,1,3,7,14,-4,10,-40,-0.069,,
7,NA,1935,2,3,1,9,11,20,-2,20,-40,-0.069,,
7,NA,1936,4.5,4,5,9,11,21,-2,20,-40,-0.069,,
7,NA,1937,3,3,3,9,11,23,-2,20,-40,-0.069,,
7,NA,1938,2.5,4,1,9,11,22,-2,20,-40,-0.069,,
7,NA,1939,2.5,2,3,9,11,23,-2,20,-40,-0.069,,
7,NA,1940,3,3,3,3,7,13,-4,10,-40,-0.069,,
7,NA,1941,4,4,4,3,7,11,-4,10,-40,-0.069,,
7,NA,1942,4.5,5,4,20,21,43,-1,41,-41,-0.071,,
7,NA,1943,2,3,1,21,22,45,-1,43,-43,-0.075,,
7,NA,1944,3,5,1,21,22,44,-1,43,-43,-0.075,,
7,NA,1945,3,5,1,21,22,45,-1,43,-43,-0.075,,
7,NA,1946,3,5,1,10,12,25,-2,22,-44,-0.076,,
7,NA,1947,2.5,3,2,10,12,23,-2,22,-44,-0.076,,
7,NA,1948,2.5,1,4,10,12,24,-2,22,-44,-0.076,,
7,NA,1949,4.5,4,5,10,12,25,-2,22,-44,-0.076,,
7,NA,1950,3.5,5,2,10,12,24,-2,22,-44,-0.076,,
7,NA,1951,3,3,3,10,12,23,-2,22,-44,-0.076,,
7,NA,1952,4,5,3,10,12,28,-2,22,-44,-0.076,,
7,NA,1953,2.5,2,3,10,12,26,-2,22,-44,-0.076,,
7,NA,1954,5,5,5,10,12,24,-2,22,-44,-0.076,,
7,NA,1955,2,2,2,10,12,26,-2,22,-44,-0.076,,
7,NA,1956,2.5,1,4,10,12,24,-2,22,-44,-0.076,,
7,NA,1957,3,1,5,10,12,25,-2,22,-44,-0.076,,
7,NA,1958,5,5,5,10,12,24,-2,22,-44,-0.076,,
7,NA,1959,1.5,2,1,10,12,24,-2,22,-44,-0.076,,
7,NA,1960,3.5,3,4,10,12,25,-2,22,-44,-0.076,,
7,NA,1961,4.5,5,4,10,12,23,-2,22,-44,-0.076,,
7,NA,1962,3.5,4,3,10,12,22,-2,22,-44,-0.076,,
7,NA,1963,2.5,2,3,10,12,23,-2,22,-44,-0.076,,
7,NA,1964,4.5,5,4,10,12,24,-2,22,-44,-0.076,,
7,NA,1965,4.5,4,5,10,12,24,-2,22,-44,-0.076,,
7,NA,1966,2,3,1,10,12,23,-2,22,-44,-0.076,,
7,NA,1967,1,1,1,10,12,22,-2,22,-44,-0.076,,
7,NA,1968,2.5,1,4,10,12,23,-2,22,-44,-0.076,,
7,NA,1969,1.5,1,2,10,12,26,-2,22,-44,-0.076,,
7,NA,1970,2,2,2,10,12,24,-2,22,-44,-0.076,,
7,NA,1971,2,2,2,10,12,24,-2,22,-44,-0.076,,
7,NA,1972,3,3,3,10,12,23,-2,22,-44,-0.076,,
7,NA,1973,2,1,3,10,12,25,-2,22,-44,-0.076,,
7,NA,1974,4.5,4,5,6,9,16,-3,15,-45,-0.078,,
7,NA,1975,1.5,1,2,22,23,47,-1,45,-45,-0.078,,
7,NA,1976,2,3,1,6,9,15,-3,15,-45,-0.078,,
7,NA,1977,4,4,4,2,7,11,-5,9,-45,-0.078,,
7,NA,1978,3.5,3,4,6,9,16,-3,15,-45,-0.078,,
7,NA,1979,4,3,5,6,9,17,-3,15,-45,-0.078,,
7,NA,1980,4,4,4,6,9,19,-3,15,-45,-0.078,,
7,NA,1981,4,4,4,6,9,18,-3,15,-45,-0.078,,
7,NA,1982,4,4,4,2,7,24,-5,9,-45,-0.078,,
7,NA,1983,3.5,3,4,6,9,16,-3,15,-45,-0.078,,
7,NA,1984,1,1,1,6,9,20,-3,15,-45,-0.078,,
7,NA,1985,3,2,4,6,9,17,-3,15,-45,-0.078,,
7,NA,1986,2.5,4,1,6,9,17,-3,15,-45,-0.078,,
7,NA,1987,2.5,4,1,6,9,15,-3,15,-45,-0.078,,
7,NA,1988,3,1,5,6,9,17,-3,15,-45,-0.078,,
7,NA,1989,2,1,3,6,9,16,-3,15,-45,-0.078,,
7,NA,1990,2,2,2,6,9,18,-3,15,-45,-0.078,,
7,NA,1991,2,3,1,6,9,16,-3,15,-45,-0.078,,
7,NA,1992,3.5,2,5,6,9,16,-3,15,-45,-0.078,,
7,NA,1993,2,2,2,6,9,16,-3,15,-45,-0.078,,
7,NA,1994,1.5,1,2,2,7,11,-5,9,-45,-0.078,,
7,NA,1995,2.5,2,3,6,9,16,-3,15,-45,-0.078,,
7,NA,1996,1.5,2,1,11,13,24,-2,24,-48,-0.083,,
7,NA,1997,4,3,5,11,13,25,-2,24,-48,-0.083,,
7,NA,1998,3.5,2,5,1,7,9,-6,8,-48,-0.083,,
7,NA,1999,2.5,2,3,11,13,24,-2,24,-48,-0.083,,
7,NA,2000,2,2,2,4,8,12,-4,12,-48,-0.083,,
7,NA,2001,4,4,4,1,7,11,-6,8,-48,-0.083,,
7,NA,2002,4.5,5,4,1,7,8,-6,8,-48,-0.083,,
7,NA,2003,1.5,1,2,11,13,24,-2,24,-48,-0.083,,
7,NA,2004,2.5,2,3,4,8,12,-4,12,-48,-0.083,,
7,NA,2005,2,1,3,11,13,26,-2,24,-48,-0.083,,
7,NA,2006,3,4,2,11,13,25,-2,24,-48,-0.083,,
7,NA,2007,3,5,1,11,13,27,-2,24,-48,-0.083,,
7,NA,2008,3.5,4,3,4,8,15,-4,12,-48,-0.083,,
7,NA,2009,4.5,4,5,11,13,27,-2,24,-48,-0.083,,
7,NA,2010,4.5,5,4,4,8,14,-4,12,-48,-0.083,,
7,NA,2011,3.5,5,2,11,13,26,-2,24,-48,-0.083,,
7,NA,2012,2,2,2,11,13,25,-2,24,-48,-0.083,,
7,NA,2013,3.5,3,4,11,13,26,-2,24,-48,-0.083,,
7,NA,2014,2.5,4,1,4,8,14,-4,12,-48,-0.083,,
7,NA,2015,3,3,3,4,8,13,-4,12,-48,-0.083,,
7,NA,2016,3,3,3,4,8,14,-4,12,-48,-0.083,,
7,NA,2017,2,3,1,11,13,28,-2,24,-48,-0.083,,
7,NA,2018,2,3,1,11,13,25,-2,24,-48,-0.083,,
7,NA,2019,5,5,5,11,13,24,-2,24,-48,-0.083,,
7,NA,2020,1.5,2,1,4,8,12,-4,12,-48,-0.083,,
7,NA,2021,1.5,1,2,11,13,26,-2,24,-48,-0.083,,
7,NA,2022,2,3,1,11,13,24,-2,24,-48,-0.083,,
7,NA,2023,4.5,4,5,11,13,25,-2,24,-48,-0.083,,
7,NA,2024,5,5,5,11,13,29,-2,24,-48,-0.083,,
7,NA,2025,1,1,1,11,13,25,-2,24,-48,-0.083,,
7,NA,2026,2.5,3,2,11,13,26,-2,24,-48,-0.083,,
7,NA,2027,2.5,3,2,11,13,26,-2,24,-48,-0.083,,
7,NA,2028,3,3,3,11,13,27,-2,24,-48,-0.083,,
7,NA,2029,3,3,3,4,8,15,-4,12,-48,-0.083,,
7,NA,2030,4,3,5,1,7,12,-6,8,-48,-0.083,,
7,NA,2031,4,4,4,11,13,29,-2,24,-48,-0.083,,
7,NA,2032,4.5,4,5,7,10,19,-3,17,-51,-0.089,,
7,NA,2033,4.5,5,4,7,10,23,-3,17,-51,-0.089,,
7,NA,2034,4,4,4,7,10,22,-3,17,-51,-0.089,,
7,NA,2035,2.5,2,3,7,10,19,-3,17,-51,-0.089,,
7,NA,2036,3.5,4,3,7,10,20,-3,17,-51,-0.089,,
7,NA,2037,3,2,4,7,10,17,-3,17,-51,-0.089,,
7,NA,2038,3,4,2,7,10,18,-3,17,-51,-0.089,,
7,NA,2039,2,2,2,7,10,17,-3,17,-51,-0.089,,
7,NA,2040,3.5,5,2,7,10,18,-3,17,-51,-0.089,,
7,NA,2041,3,4,2,7,10,17,-3,17,-51,-0.089,,
7,NA,2042,2.5,1,4,7,10,18,-3,17,-51,-0.089,,
7,NA,2043,2.5,2,3,7,10,18,-3,17,-51,-0.089,,
7,NA,2044,2,1,3,7,10,23,-3,17,-51,-0.089,,
7,NA,2045,3.5,4,3,7,10,17,-3,17,-51,-0.089,,
7,NA,2046,1,1,1,7,10,19,-3,17,-51,-0.089,,
7,NA,2047,3,3,3,7,10,24,-3,17,-51,-0.089,,
7,NA,2048,3,5,1,7,10,17,-3,17,-51,-0.089,,
7,NA,2049,2.5,1,4,7,10,18,-3,17,-51,-0.089,,
7,NA,2050,3.5,4,3,7,10,17,-3,17,-51,-0.089,,
7,NA,2051,2.5,3,2,7,10,19,-3,17,-51,-0.089,,
7,NA,2052,3,3,3,12,14,26,-2,26,-52,-0.090,,
7,NA,2053,2.5,4,1,12,14,27,-2,26,-52,-0.090,,
7,NA,2054,4.5,5,4,12,14,27,-2,26,-52,-0.090,,
7,NA,2055,3.5,2,5,12,14,27,-2,26,-52,-0.090,,
7,NA,2056,4,4,4,12,14,29,-2,26,-52,-0.090,,
7,NA,2057,3,4,2,12,14,27,-2,26,-52,-0.090,,
7,NA,2058,2,2,2,3,8,16,-5,11,-55,-0.095,,
7,NA,2059,3.5,4,3,3,8,14,-5,11,-55,-0.095,,
7,NA,2060,1.5,2,1,3,8,12,-5,11,-55,-0.095,,
7,NA,2061,2.5,3,2,13,15,29,-2,28,-56,-0.097,,
7,NA,2062,3,5,1,13,15,31,-2,28,-56,-0.097,,
7,NA,2063,3.5,3,4,5,9,15,-4,14,-56,-0.097,,
7,NA,2064,3,4,2,5,9,14,-4,14,-56,-0.097,,
7,NA,2065,4,5,3,5,9,15,-4,14,-56,-0.097,,
7,NA,2066,4,4,4,13,15,29,-2,28,-56,-0.097,,
7,NA,2067,4.5,4,5,5,9,17,-4,14,-56,-0.097,,
7,NA,2068,4.5,4,5,5,9,17,-4,14,-56,-0.097,,
7,NA,2069,3,2,4,5,9,15,-4,14,-56,-0.097,,
7,NA,2070,2,2,2,13,15,32,-2,28,-56,-0.097,,
7,NA,2071,2.5,1,4,5,9,16,-4,14,-56,-0.097,,
7,NA,2072,2,3,1,5,9,17,-4,14,-56,-0.097,,
7,NA,2073,2,2,2,5,9,16,-4,14,-56,-0.097,,
7,NA,2074,3,3,3,5,9,14,-4,14,-56,-0.097,,
7,NA,2075,2.5,1,4,5,9,16,-4,14,-56,-0.097,,
7,NA,2076,2,2,2,5,9,15,-4,14,-56,-0.097,,
7,NA,2077,3,3,3,5,9,17,-4,14,-56,-0.097,,
7,NA,2078,3,4,2,5,9,16,-4,14,-56,-0.097,,
7,NA,2079,2.5,3,2,8,11,21,-3,19,-57,-0.099,,
7,NA,2080,2.5,2,3,8,11,20,-3,19,-57,-0.099,,
7,NA,2081,3.5,4,3,8,11,19,-3,19,-57,-0.099,,
7,NA,2082,1.5,2,1,8,11,19,-3,19,-57,-0.099,,
7,NA,2083,3.5,4,3,8,11,21,-3,19,-57,-0.099,,
7,NA,2084,3,2,4,8,11,22,-3,19,-57,-0.099,,
7,NA,2085,3,3,3,8,11,20,-3,19,-57,-0.099,,
7,NA,2086,2.5,3,2,8,11,19,-3,19,-57,-0.099,,
7,NA,2087,3.5,4,3,8,11,21,-3,19,-57,-0.099,,
7,NA,2088,3.5,2,5,8,11,22,-3,19,-57,-0.099,,
7,NA,2089,4,4,4,8,11,20,-3,19,-57,-0.099,,
7,NA,2090,4,4,4,8,11,20,-3,19,-57,-0.099,,
7,NA,2091,2,2,2,8,11,20,-3,19,-57,-0.099,,
7,NA,2092,3.5,2,5,8,11,21,-3,19,-57,-0.099,,
7,NA,2093,3.5,4,3,8,11,21,-3,19,-57,-0.099,,
7,NA,2094,3.5,4,3,8,11,22,-3,19,-57,-0.099,,
7,NA,2095,4.5,4,5,8,11,21,-3,19,-57,-0.099,,
7,NA,2096,3.5,4,3,8,11,20,-3,19,-57,-0.099,,
7,NA,2097,2.5,4,1,8,11,19,-3,19,-57,-0.099,,
7,NA,2098,3.5,3,4,8,11,21,-3,19,-57,-0.099,,
7,NA,2099,3.5,3,4,8,11,19,-3,19,-57,-0.099,,
7,NA,2100,3,3,3,8,11,19,-3,19,-57,-0.099,,
7,NA,2101,3.5,3,4,8,11,21,-3,19,-57,-0.099,,
7,NA,2102,3.5,3,4,8,11,20,-3,19,-57,-0.099,,
7,NA,2103,2,2,2,8,11,20,-3,19,-57,-0.099,,
7,NA,2104,3.5,4,3,8,11,20,-3,19,-57,-0.099,,
7,NA,2105,3.5,2,5,8,11,19,-3,19,-57,-0.099,,
7,NA,2106,4.5,4,5,8,11,21,-3,19,-57,-0.099,,
7,NA,2107,1,1,1,8,11,20,-3,19,-57,-0.099,,
7,NA,2108,4,3,5,8,11,19,-3,19,-57,-0.099,,
7,NA,2109,3,2,4,8,11,21,-3,19,-57,-0.099,,
7,NA,2110,2,3,1,8,11,22,-3,19,-57,-0.099,,
7,NA,2111,3.5,4,3,8,11,19,-3,19,-57,-0.099,,
7,NA,2112,2.5,2,3,14,16,31,-2,30,-60,-0.104,,
7,NA,2113,3,4,2,2,8,10,-6,10,-60,-0.104,,
7,NA,2114,2.5,2,3,2,8,10,-6,10,-60,-0.104,,
7,NA,2115,3,5,1,14,16,33,-2,30,-60,-0.104,,
7,NA,2116,2,3,1,14,16,32,-2,30,-60,-0.104,,
7,NA,2117,3,3,3,14,16,31,-2,30,-60,-0.104,,
7,NA,2118,2.5,4,1,9,12,21,-3,21,-63,-0.109,,
7,NA,2119,2.5,4,1,9,12,22,-3,21,-63,-0.109,,
7,NA,2120,3,3,3,9,12,23,-3,21,-63,-0.109,,
7,NA,2121,3.5,3,4,9,12,21,-3,21,-63,-0.109,,
7,NA,2122,3.5,4,3,9,12,21,-3,21,-63,-0.109,,
7,NA,2123,2.5,2,3,9,12,22,-3,21,-63,-0.109,,
7,NA,2124,3.5,4,3,9,12,22,-3,21,-63,-0.109,,
7,NA,2125,2.5,4,1,9,12,22,-3,21,-63,-0.109,,
7,NA,2126,4,4,4,9,12,22,-3,21,-63,-0.109,,
7,NA,2127,2.5,2,3,9,12,27,-3,21,-63,-0.109,,
7,NA,2128,2,1,3,9,12,23,-3,21,-63,-0.109,,
7,NA,2129,3,4,2,9,12,22,-3,21,-63,-0.109,,
7,NA,2130,4,5,3,9,12,24,-3,21,-63,-0.109,,
7,NA,2131,2,2,2,9,12,26,-3,21,-63,-0.109,,
7,NA,2132,3,1,5,9,12,26,-3,21,-63,-0.109,,
7,NA,2133,1.5,2,1,9,12,24,-3,21,-63,-0.109,,
7,NA,2134,2.5,4,1,9,12,27,-3,21,-63,-0.109,,
7,NA,2135,2,2,2,6,10,16,-4,16,-64,-0.111,,
7,NA,2136,5,5,5,6,10,18,-4,16,-64,-0.111,,
7,NA,2137,2.5,3,2,6,10,17,-4,16,-64,-0.111,,
7,NA,2138,3,2,4,6,10,18,-4,16,-64,-0.111,,
7,NA,2139,1.5,1,2,15,17,37,-2,32,-64,-0.111,,
7,NA,2140,3.5,4,3,6,10,17,-4,16,-64,-0.111,,
7,NA,2141,2.5,2,3,6,10,17,-4,16,-64,-0.111,,
7,NA,2142,4,4,4,6,10,17,-4,16,-64,-0.111,,
7,NA,2143,3,3,3,6,10,17,-4,16,-64,-0.111,,
7,NA,2144,3,5,1,6,10,16,-4,16,-64,-0.111,,
7,NA,2145,2,2,2,6,10,21,-4,16,-64,-0.111,,
7,NA,2146,4,5,3,6,10,18,-4,16,-64,-0.111,,
7,NA,2147,3,4,2,6,10,20,-4,16,-64,-0.111,,
7,NA,2148,2.5,3,2,4,9,14,-5,13,-65,-0.113,,
7,NA,2149,2.5,2,3,4,9,14,-5,13,-65,-0.113,,
7,NA,2150,3.5,5,2,4,9,15,-5,13,-65,-0.113,,
7,NA,2151,3,3,3,4,9,14,-5,13,-65,-0.113,,
7,NA,2152,3.5,2,5,4,9,16,-5,13,-65,-0.113,,
7,NA,2153,4,4,4,4,9,14,-5,13,-65,-0.113,,
7,NA,2154,2.5,4,1,4,9,15,-5,13,-65,-0.113,,
7,NA,2155,2,3,1,4,9,16,-5,13,-65,-0.113,,
7,NA,2156,3.5,4,3,16,18,38,-2,34,-68,-0.118,,
7,NA,2157,2.5,1,4,10,13,24,-3,23,-69,-0.120,,
7,NA,2158,3.5,3,4,10,13,25,-3,23,-69,-0.120,,
7,NA,2159,3,2,4,10,13,27,-3,23,-69,-0.120,,
7,NA,2160,3.5,3,4,10,13,24,-3,23,-69,-0.120,,
7,NA,2161,2.5,2,3,10,13,24,-3,23,-69,-0.120,,
7,NA,2162,3.5,3,4,10,13,26,-3,23,-69,-0.120,,
7,NA,2163,4,4,4,10,13,28,-3,23,-69,-0.120,,
7,NA,2164,1.5,2,1,10,13,28,-3,23,-69,-0.120,,
7,NA,2165,3.5,2,5,10,13,24,-3,23,-69,-0.120,,
7,NA,2166,3.5,4,3,10,13,24,-3,23,-69,-0.120,,
7,NA,2167,2,3,1,10,13,29,-3,23,-69,-0.120,,
7,NA,2168,2.5,3,2,10,13,23,-3,23,-69,-0.120,,
7,NA,2169,3,4,2,10,13,24,-3,23,-69,-0.120,,
7,NA,2170,2.5,2,3,10,13,24,-3,23,-69,-0.120,,
7,NA,2171,3,4,2,10,13,24,-3,23,-69,-0.120,,
7,NA,2172,2,2,2,10,13,25,-3,23,-69,-0.120,,
7,NA,2173,3,3,3,10,13,27,-3,23,-69,-0.120,,
7,NA,2174,4,3,5,3,9,12,-6,12,-72,-0.125,,
7,NA,2175,2.5,3,2,7,11,21,-4,18,-72,-0.125,,
7,NA,2176,2,2,2,7,11,18,-4,18,-72,-0.125,,
7,NA,2177,3,2,4,7,11,18,-4,18,-72,-0.125,,
7,NA,2178,3,3,3,7,11,19,-4,18,-72,-0.125,,
7,NA,2179,3,4,2,3,9,14,-6,12,-72,-0.125,,
7,NA,2180,2.5,1,4,7,11,21,-4,18,-72,-0.125,,
7,NA,2181,3,3,3,7,11,21,-4,18,-72,-0.125,,
7,NA,2182,1.5,2,1,3,9,15,-6,12,-72,-0.125,,
7,NA,2183,3,4,2,7,11,19,-4,18,-72,-0.125,,
7,NA,2184,3,1,5,7,11,19,-4,18,-72,-0.125,,
7,NA,2185,3.5,2,5,7,11,19,-4,18,-72,-0.125,,
7,NA,2186,3,2,4,17,19,38,-2,36,-72,-0.125,,
7,NA,2187,2.5,3,2,7,11,19,-4,18,-72,-0.125,,
7,NA,2188,2,2,2,3,9,14,-6,12,-72,-0.125,,
7,NA,2189,2.5,2,3,7,11,19,-4,18,-72,-0.125,,
7,NA,2190,3.5,4,3,17,19,37,-2,36,-72,-0.125,,
7,NA,2191,1,1,1,7,11,22,-4,18,-72,-0.125,,
7,NA,2192,2,2,2,7,11,19,-4,18,-72,-0.125,,
7,NA,2193,2,2,2,7,11,19,-4,18,-72,-0.125,,
7,NA,2194,4.5,5,4,7,11,18,-4,18,-72,-0.125,,
7,NA,2195,4.5,5,4,11,14,26,-3,25,-75,-0.130,,
7,NA,2196,3,2,4,11,14,26,-3,25,-75,-0.130,,
7,NA,2197,3,1,5,5,10,15,-5,15,-75,-0.130,,
7,NA,2198,2.5,2,3,5,10,17,-5,15,-75,-0.130,,
7,NA,2199,1,1,1,11,14,25,-3,25,-75,-0.130,,
7,NA,2200,5,5,5,5,10,16,-5,15,-75,-0.130,,
7,NA,2201,3.5,4,3,11,14,26,-3,25,-75,-0.130,,
7,NA,2202,3.5,4,3,11,14,28,-3,25,-75,-0.130,,
7,NA,2203,2,3,1,11,14,26,-3,25,-75,-0.130,,
7,NA,2204,2,3,1,5,10,16,-5,15,-75,-0.130,,
7,NA,2205,2.5,3,2,5,10,16,-5,15,-75,-0.130,,
7,NA,2206,2,2,2,11,14,27,-3,25,-75,-0.130,,
7,NA,2207,2,3,1,11,14,28,-3,25,-75,-0.130,,
7,NA,2208,3,5,1,11,14,25,-3,25,-75,-0.130,,
7,NA,2209,3.5,4,3,11,14,28,-3,25,-75,-0.130,,
7,NA,2210,3,4,2,5,10,16,-5,15,-75,-0.130,,
7,NA,2211,3,2,4,5,10,17,-5,15,-75,-0.130,,
7,NA,2212,3,3,3,11,14,26,-3,25,-75,-0.130,,
7,NA,2213,2,3,1,18,20,40,-2,38,-76,-0.132,,
7,NA,2214,3.5,3,4,18,20,38,-2,38,-76,-0.132,,
7,NA,2215,2,2,2,19,21,42,-2,40,-80,-0.139,,
7,NA,2216,2.5,2,3,8,12,23,-4,20,-80,-0.139,,
7,NA,2217,2,3,1,8,12,22,-4,20,-80,-0.139,,
7,NA,2218,1,1,1,8,12,20,-4,20,-80,-0.139,,
7,NA,2219,2,1,3,1,9,11,-8,10,-80,-0.139,,
7,NA,2220,2.5,3,2,8,12,23,-4,20,-80,-0.139,,
7,NA,2221,4,3,5,8,12,24,-4,20,-80,-0.139,,
7,NA,2222,2.5,2,3,8,12,20,-4,20,-80,-0.139,,
7,NA,2223,2,1,3,8,12,21,-4,20,-80,-0.139,,
7,NA,2224,2.5,2,3,8,12,22,-4,20,-80,-0.139,,
7,NA,2225,2.5,4,1,8,12,20,-4,20,-80,-0.139,,
7,NA,2226,2,1,3,8,12,27,-4,20,-80,-0.139,,
7,NA,2227,2,1,3,8,12,21,-4,20,-80,-0.139,,
7,NA,2228,4,5,3,8,12,21,-4,20,-80,-0.139,,
7,NA,2229,2.5,3,2,8,12,21,-4,20,-80,-0.139,,
7,NA,2230,3.5,3,4,8,12,22,-4,20,-80,-0.139,,
7,NA,2231,3,4,2,8,12,21,-4,20,-80,-0.139,,
7,NA,2232,3,5,1,8,12,21,-4,20,-80,-0.139,,
7,NA,2233,2.5,3,2,8,12,22,-4,20,-80,-0.139,,
7,NA,2234,2.5,4,1,8,12,25,-4,20,-80,-0.139,,
7,NA,2235,2.5,4,1,8,12,21,-4,20,-80,-0.139,,
7,NA,2236,4,5,3,8,12,23,-4,20,-80,-0.139,,
7,NA,2237,2,3,1,8,12,24,-4,20,-80,-0.139,,
7,NA,2238,3.5,5,2,8,12,22,-4,20,-80,-0.139,,
7,NA,2239,2,2,2,8,12,22,-4,20,-80,-0.139,,
7,NA,2240,2.5,2,3,8,12,20,-4,20,-80,-0.139,,
7,NA,2241,2,2,2,8,12,20,-4,20,-80,-0.139,,
7,NA,2242,3.5,3,4,8,12,23,-4,20,-80,-0.139,,
7,NA,2243,3,4,2,8,12,21,-4,20,-80,-0.139,,
7,NA,2244,2,2,2,8,12,22,-4,20,-80,-0.139,,
7,NA,2245,2.5,1,4,12,15,28,-3,27,-81,-0.141,,
7,NA,2246,3.5,4,3,12,15,29,-3,27,-81,-0.141,,
7,NA,2247,2.5,4,1,12,15,28,-3,27,-81,-0.141,,
7,NA,2248,3,4,2,12,15,32,-3,27,-81,-0.141,,
7,NA,2249,2.5,3,2,12,15,30,-3,27,-81,-0.141,,
7,NA,2250,4,5,3,12,15,29,-3,27,-81,-0.141,,
7,NA,2251,1.5,2,1,12,15,36,-3,27,-81,-0.141,,
7,NA,2252,4,3,5,4,10,17,-6,14,-84,-0.146,,
7,NA,2253,3.5,4,3,4,10,16,-6,14,-84,-0.146,,
7,NA,2254,3,4,2,20,22,44,-2,42,-84,-0.146,,
7,NA,2255,3.5,3,4,6,11,20,-5,17,-85,-0.148,,
7,NA,2256,2.5,3,2,6,11,20,-5,17,-85,-0.148,,
7,NA,2257,3.5,3,4,6,11,17,-5,17,-85,-0.148,,
7,NA,2258,2.5,3,2,6,11,21,-5,17,-85,-0.148,,
7,NA,2259,4,4,4,6,11,18,-5,17,-85,-0.148,,
7,NA,2260,2,3,1,6,11,22,-5,17,-85,-0.148,,
7,NA,2261,3.5,2,5,6,11,21,-5,17,-85,-0.148,,
7,NA,2262,3,3,3,6,11,19,-5,17,-85,-0.148,,
7,NA,2263,3,5,1,6,11,18,-5,17,-85,-0.148,,
7,NA,2264,3,3,3,6,11,18,-5,17,-85,-0.148,,
7,NA,2265,4,4,4,13,16,32,-3,29,-87,-0.151,,
7,NA,2266,3.5,3,4,13,16,30,-3,29,-87,-0.151,,
7,NA,2267,2,3,1,9,13,23,-4,22,-88,-0.153,,
7,NA,2268,1,1,1,9,13,22,-4,22,-88,-0.153,,
7,NA,2269,3,5,1,9,13,22,-4,22,-88,-0.153,,
7,NA,2270,3.5,5,2,9,13,25,-4,22,-88,-0.153,,
7,NA,2271,2,3,1,9,13,25,-4,22,-88,-0.153,,
7,NA,2272,3.5,3,4,9,13,23,-4,22,-88,-0.153,,
7,NA,2273,2.5,2,3,9,13,24,-4,22,-88,-0.153,,
7,NA,2274,2,2,2,9,13,25,-4,22,-88,-0.153,,
7,NA,2275,2.5,4,1,9,13,23,-4,22,-88,-0.153,,
7,NA,2276,2,1,3,9,13,25,-4,22,-88,-0.153,,
7,NA,2277,3.5,5,2,9,13,23,-4,22,-88,-0.153,,
7,NA,2278,2.5,4,1,9,13,24,-4,22,-88,-0.153,,
7,NA,2279,3,3,3,9,13,22,-4,22,-88,-0.153,,
7,NA,2280,2.5,4,1,9,13,24,-4,22,-88,-0.153,,
7,NA,2281,3.5,3,4,9,13,22,-4,22,-88,-0.153,,
7,NA,2282,3.5,4,3,9,13,25,-4,22,-88,-0.153,,
7,NA,2283,2.5,3,2,3,10,13,-7,13,-91,-0.158,,
7,NA,2284,2,1,3,14,17,31,-3,31,-93,-0.161,,
7,NA,2285,3,3,3,14,17,31,-3,31,-93,-0.161,,
7,NA,2286,3.5,2,5,14,17,34,-3,31,-93,-0.161,,
7,NA,2287,3,2,4,14,17,40,-3,31,-93,-0.161,,
7,NA,2288,2.5,3,2,7,12,20,-5,19,-95,-0.165,,
7,NA,2289,2.5,2,3,7,12,20,-5,19,-95,-0.165,,
7,NA,2290,3.5,4,3,7,12,19,-5,19,-95,-0.165,,
7,NA,2291,1.5,1,2,7,12,20,-5,19,-95,-0.165,,
7,NA,2292,3,3,3,7,12,20,-5,19,-95,-0.165,,
7,NA,2293,2,2,2,7,12,21,-5,19,-95,-0.165,,
7,NA,2294,4.5,4,5,7,12,20,-5,19,-95,-0.165,,
7,NA,2295,2,2,2,7,12,22,-5,19,-95,-0.165,,
7,NA,2296,3,5,1,7,12,20,-5,19,-95,-0.165,,
7,NA,2297,2.5,4,1,7,12,20,-5,19,-95,-0.165,,
7,NA,2298,3.5,4,3,7,12,21,-5,19,-95,-0.165,,
7,NA,2299,2.5,2,3,7,12,23,-5,19,-95,-0.165,,
7,NA,2300,2.5,2,3,7,12,24,-5,19,-95,-0.165,,
7,NA,2301,2,2,2,7,12,22,-5,19,-95,-0.165,,
7,NA,2302,4.5,4,5,7,12,24,-5,19,-95,-0.165,,
7,NA,2303,3.5,4,3,10,14,24,-4,24,-96,-0.167,,
7,NA,2304,3,5,1,10,14,25,-4,24,-96,-0.167,,
7,NA,2305,2.5,4,1,5,11,19,-6,16,-96,-0.167,,
7,NA,2306,4.5,4,5,10,14,25,-4,24,-96,-0.167,,
7,NA,2307,3,4,2,5,11,17,-6,16,-96,-0.167,,
7,NA,2308,3,4,2,10,14,27,-4,24,-96,-0.167,,
7,NA,2309,2.5,4,1,10,14,30,-4,24,-96,-0.167,,
7,NA,2310,2.5,4,1,5,11,17,-6,16,-96,-0.167,,
7,NA,2311,2,1,3,10,14,26,-4,24,-96,-0.167,,
7,NA,2312,3,1,5,10,14,24,-4,24,-96,-0.167,,
7,NA,2313,4,4,4,10,14,26,-4,24,-96,-0.167,,
7,NA,2314,2.5,3,2,10,14,24,-4,24,-96,-0.167,,
7,NA,2315,2.5,4,1,5,11,23,-6,16,-96,-0.167,,
7,NA,2316,2,1,3,15,18,37,-3,33,-99,-0.172,,
7,NA,2317,3.5,4,3,15,18,34,-3,33,-99,-0.172,,
7,NA,2318,3,3,3,15,18,36,-3,33,-99,-0.172,,
7,NA,2319,4,4,4,15,18,36,-3,33,-99,-0.172,,
7,NA,2320,2,2,2,11,15,29,-4,26,-104,-0.181,,
7,NA,2321,3,2,4,11,15,28,-4,26,-104,-0.181,,
7,NA,2322,2,2,2,11,15,28,-4,26,-104,-0.181,,
7,NA,2323,3.5,2,5,11,15,28,-4,26,-104,-0.181,,
7,NA,2324,3,2,4,8,13,23,-5,21,-105,-0.182,,
7,NA,2325,2,2,2,8,13,22,-5,21,-105,-0.182,,
7,NA,2326,2,2,2,8,13,23,-5,21,-105,-0.182,,
7,NA,2327,4,5,3,4,11,17,-7,15,-105,-0.182,,
7,NA,2328,2.5,2,3,8,13,21,-5,21,-105,-0.182,,
7,NA,2329,3.5,4,3,8,13,26,-5,21,-105,-0.182,,
7,NA,2330,3,3,3,4,11,17,-7,15,-105,-0.182,,
7,NA,2331,4.5,4,5,4,11,17,-7,15,-105,-0.182,,
7,NA,2332,3,4,2,4,11,15,-7,15,-105,-0.182,,
7,NA,2333,1.5,2,1,8,13,23,-5,21,-105,-0.182,,
7,NA,2334,2,2,2,4,11,17,-7,15,-105,-0.182,,
7,NA,2335,3.5,3,4,8,13,22,-5,21,-105,-0.182,,
7,NA,2336,2,3,1,8,13,21,-5,21,-105,-0.182,,
7,NA,2337,3,4,2,8,13,22,-5,21,-105,-0.182,,
7,NA,2338,2.5,2,3,8,13,21,-5,21,-105,-0.182,,
7,NA,2339,4,4,4,8,13,22,-5,21,-105,-0.182,,
7,NA,2340,3,2,4,8,13,23,-5,21,-105,-0.182,,
7,NA,2341,2.5,2,3,8,13,22,-5,21,-105,-0.182,,
7,NA,2342,2.5,3,2,8,13,21,-5,21,-105,-0.182,,
7,NA,2343,3,4,2,16,19,37,-3,35,-105,-0.182,,
7,NA,2344,3,3,3,8,13,21,-5,21,-105,-0.182,,
7,NA,2345,3.5,3,4,8,13,22,-5,21,-105,-0.182,,
7,NA,2346,2,1,3,8,13,25,-5,21,-105,-0.182,,
7,NA,2347,3,4,2,6,12,20,-6,18,-108,-0.188,,
7,NA,2348,5,5,5,6,12,19,-6,18,-108,-0.188,,
7,NA,2349,2.5,2,3,6,12,21,-6,18,-108,-0.188,,
7,NA,2350,2,2,2,6,12,19,-6,18,-108,-0.188,,
7,NA,2351,3.5,3,4,6,12,20,-6,18,-108,-0.188,,
7,NA,2352,3.5,2,5,6,12,21,-6,18,-108,-0.188,,
7,NA,2353,4.5,4,5,6,12,19,-6,18,-108,-0.188,,
7,NA,2354,3,4,2,6,12,18,-6,18,-108,-0.188,,
7,NA,2355,3,1,5,17,20,40,-3,37,-111,-0.193,,
7,NA,2356,3,1,5,17,20,39,-3,37,-111,-0.193,,
7,NA,2357,3.5,4,3,17,20,40,-3,37,-111,-0.193,,
7,NA,2358,3,3,3,12,16,30,-4,28,-112,-0.194,,
7,NA,2359,5,5,5,12,16,38,-4,28,-112,-0.194,,
7,NA,2360,4.5,4,5,12,16,29,-4,28,-112,-0.194,,
7,NA,2361,1.5,2,1,12,16,30,-4,28,-112,-0.194,,
7,NA,2362,3.5,3,4,12,16,28,-4,28,-112,-0.194,,
7,NA,2363,3.5,4,3,12,16,30,-4,28,-112,-0.194,,
7,NA,2364,1,1,1,9,14,25,-5,23,-115,-0.200,,
7,NA,2365,4,3,5,9,14,25,-5,23,-115,-0.200,,
7,NA,2366,3,2,4,9,14,26,-5,23,-115,-0.200,,
7,NA,2367,4.5,5,4,9,14,26,-5,23,-115,-0.200,,
7,NA,2368,3.5,4,3,9,14,24,-5,23,-115,-0.200,,
7,NA,2369,2,2,2,9,14,26,-5,23,-115,-0.200,,
7,NA,2370,3,2,4,9,14,24,-5,23,-115,-0.200,,
7,NA,2371,4,4,4,9,14,25,-5,23,-115,-0.200,,
7,NA,2372,2,2,2,9,14,24,-5,23,-115,-0.200,,
7,NA,2373,3.5,4,3,9,14,23,-5,23,-115,-0.200,,
7,NA,2374,2.5,3,2,5,12,20,-7,17,-119,-0.207,,
7,NA,2375,2.5,3,2,5,12,18,-7,17,-119,-0.207,,
7,NA,2376,3,4,2,5,12,17,-7,17,-119,-0.207,,
7,NA,2377,4,4,4,5,12,22,-7,17,-119,-0.207,,
7,NA,2378,4,4,4,5,12,19,-7,17,-119,-0.207,,
7,NA,2379,2,3,1,5,12,19,-7,17,-119,-0.207,,
7,NA,2380,1.5,2,1,5,12,20,-7,17,-119,-0.207,,
7,NA,2381,3,2,4,7,13,23,-6,20,-120,-0.208,,
7,NA,2382,4,4,4,13,17,32,-4,30,-120,-0.208,,
7,NA,2383,3.5,3,4,13,17,34,-4,30,-120,-0.208,,
7,NA,2384,4,4,4,13,17,32,-4,30,-120,-0.208,,
7,NA,2385,3,5,1,13,17,31,-4,30,-120,-0.208,,
7,NA,2386,3,4,2,7,13,23,-6,20,-120,-0.208,,
7,NA,2387,3,2,4,13,17,44,-4,30,-120,-0.208,,
7,NA,2388,3.5,3,4,13,17,35,-4,30,-120,-0.208,,
7,NA,2389,3.5,4,3,19,22,47,-3,41,-123,-0.214,,
7,NA,2390,2,1,3,10,15,27,-5,25,-125,-0.217,,
7,NA,2391,3.5,3,4,10,15,27,-5,25,-125,-0.217,,
7,NA,2392,3.5,3,4,10,15,27,-5,25,-125,-0.217,,
7,NA,2393,4,4,4,10,15,26,-5,25,-125,-0.217,,
7,NA,2394,3,4,2,10,15,27,-5,25,-125,-0.217,,
7,NA,2395,2,3,1,10,15,31,-5,25,-125,-0.217,,
7,NA,2396,4.5,4,5,14,18,33,-4,32,-128,-0.222,,
7,NA,2397,4,4,4,4,12,18,-8,16,-128,-0.222,,
7,NA,2398,2.5,3,2,4,12,17,-8,16,-128,-0.222,,
7,NA,2399,4,4,4,4,12,16,-8,16,-128,-0.222,,
7,NA,2400,3.5,4,3,14,18,33,-4,32,-128,-0.222,,
7,NA,2401,3,5,1,4,12,17,-8,16,-128,-0.222,,
7,NA,2402,2.5,3,2,20,23,46,-3,43,-129,-0.224,,
7,NA,2403,3.5,3,4,8,14,22,-6,22,-132,-0.229,,
7,NA,2404,2.5,4,1,8,14,23,-6,22,-132,-0.229,,
7,NA,2405,3,1,5,8,14,22,-6,22,-132,-0.229,,
7,NA,2406,3,3,3,8,14,23,-6,22,-132,-0.229,,
7,NA,2407,1.5,1,2,6,13,21,-7,19,-133,-0.231,,
7,NA,2408,2.5,4,1,6,13,23,-7,19,-133,-0.231,,
7,NA,2409,3,1,5,6,13,20,-7,19,-133,-0.231,,
7,NA,2410,2.5,3,2,11,16,29,-5,27,-135,-0.234,,
7,NA,2411,4,3,5,11,16,28,-5,27,-135,-0.234,,
7,NA,2412,3.5,3,4,11,16,28,-5,27,-135,-0.234,,
7,NA,2413,3,3,3,3,12,21,-9,15,-135,-0.234,,
7,NA,2414,4,5,3,11,16,30,-5,27,-135,-0.234,,
7,NA,2415,1.5,2,1,9,15,26,-6,24,-144,-0.250,,
7,NA,2416,4,4,4,9,15,26,-6,24,-144,-0.250,,
7,NA,2417,4,3,5,9,15,25,-6,24,-144,-0.250,,
7,NA,2418,1,1,1,9,15,26,-6,24,-144,-0.250,,
7,NA,2419,2,2,2,16,20,39,-4,36,-144,-0.250,,
7,NA,2420,4,3,5,9,15,24,-6,24,-144,-0.250,,
7,NA,2421,2,1,3,9,15,28,-6,24,-144,-0.250,,
7,NA,2422,3,3,3,9,15,28,-6,24,-144,-0.250,,
7,NA,2423,3.5,4,3,12,17,31,-5,29,-145,-0.252,,
7,NA,2424,3,3,3,12,17,31,-5,29,-145,-0.252,,
7,NA,2425,3.5,4,3,7,14,21,-7,21,-147,-0.255,,
7,NA,2426,3,3,3,7,14,23,-7,21,-147,-0.255,,
7,NA,2427,4,4,4,7,14,24,-7,21,-147,-0.255,,
7,NA,2428,2.5,3,2,7,14,25,-7,21,-147,-0.255,,
7,NA,2429,2,2,2,7,14,21,-7,21,-147,-0.255,,
7,NA,2430,3.5,4,3,7,14,23,-7,21,-147,-0.255,,
7,NA,2431,3,5,1,7,14,21,-7,21,-147,-0.255,,
7,NA,2432,3.5,4,3,4,13,17,-9,17,-153,-0.266,,
7,NA,2433,2.5,3,2,10,16,26,-6,26,-156,-0.271,,
7,NA,2434,2.5,2,3,10,16,27,-6,26,-156,-0.271,,
7,NA,2435,4,4,4,10,16,30,-6,26,-156,-0.271,,
7,NA,2436,2,2,2,10,16,30,-6,26,-156,-0.271,,
7,NA,2437,2,1,3,10,16,28,-6,26,-156,-0.271,,
7,NA,2438,4,5,3,10,16,27,-6,26,-156,-0.271,,
7,NA,2439,5,5,5,6,14,21,-8,20,-160,-0.278,,
7,NA,2440,3,2,4,6,14,23,-8,20,-160,-0.278,,
7,NA,2441,3,2,4,6,14,22,-8,20,-160,-0.278,,
7,NA,2442,2.5,1,4,8,15,27,-7,23,-161,-0.280,,
7,NA,2443,3.5,3,4,8,15,26,-7,23,-161,-0.280,,
7,NA,2444,2.5,3,2,8,15,23,-7,23,-161,-0.280,,
7,NA,2445,4,4,4,14,19,34,-5,33,-165,-0.286,,
7,NA,2446,4,4,4,11,17,31,-6,28,-168,-0.292,,
7,NA,2447,3.5,2,5,11,17,29,-6,28,-168,-0.292,,
7,NA,2448,1.5,2,1,9,16,28,-7,25,-175,-0.304,,
7,NA,2449,3,2,4,9,16,27,-7,25,-175,-0.304,,
7,NA,2450,3,3,3,9,16,26,-7,25,-175,-0.304,,
7,NA,2451,4,4,4,9,16,29,-7,25,-175,-0.304,,
7,NA,2452,3.5,3,4,7,15,23,-8,22,-176,-0.306,,
7,NA,2453,2,3,1,7,15,22,-8,22,-176,-0.306,,
7,NA,2454,3.5,3,4,7,15,23,-8,22,-176,-0.306,,
7,NA,2455,3,3,3,7,15,23,-8,22,-176,-0.306,,
7,NA,2456,4.5,4,5,16,21,39,-5,37,-185,-0.321,,
7,NA,2457,3,3,3,10,17,29,-7,27,-189,-0.328,,
7,NA,2458,2,3,1,10,17,27,-7,27,-189,-0.328,,
7,NA,2459,2.5,2,3,10,17,27,-7,27,-189,-0.328,,
7,NA,2460,3.5,4,3,8,16,27,-8,24,-192,-0.333,,
7,NA,2461,3,1,5,8,16,26,-8,24,-192,-0.333,,
7,NA,2462,2.5,3,2,8,16,26,-8,24,-192,-0.333,,
7,NA,2463,3.5,2,5,11,18,35,-7,29,-203,-0.352,,
7,NA,2464,3,2,4,7,16,25,-9,23,-207,-0.359,,
7,NA,2465,2.5,3,2,9,17,27,-8,26,-208,-0.361,,
7,NA,2466,2,1,3,12,19,32,-7,31,-217,-0.377,,
7,NA,2467,3,5,1,8,17,28,-9,25,-225,-0.391,,
7,NA,2468,3.5,2,5,9,18,28,-9,27,-243,-0.422,,
7,NA,2469,3,2,4,9,18,28,-9,27,-243,-0.422,,
,,,,,,,,,,,,,,
,,,,,,,,,,,,,,
,,,,,,,,,,,,,,
,,,,,,,,,,,,,,
,,,,,,,,,,,,,,
,,,,,,,,,,,,,,
